"tid","d_rt","r_rt","d_reply","r_reply","total_panel"
"1000061992042975232",8,90,26,4,128
"1000064605903876096",8,166,35,11,220
"1000114139136606209",9,148,49,8,214
"1000138164923781121",27,216,96,29,368
"1000174070061813761",12,152,90,24,278
"1000366478846300165",22,185,33,17,257
"1000375761604370434",15,165,789,75,1044
"1000385794115325952",12,88,21,10,131
"1000387893427351553",26,153,72,9,260
"1000391997969092608",19,113,99,10,241
"1000396430371106817",25,153,256,23,457
"1000458567147839488",20,168,222,31,441
"1000462031500099584",16,159,255,21,451
"1000465814192099330",17,180,262,43,502
"1000554657859670016",17,162,30,23,232
"1000718611688943616",20,169,665,64,918
"1000726832843501570",21,226,105,14,366
"1000741764565753856",23,218,270,44,555
"1000831304836018176",27,178,103,22,330
"1000837182297464832",31,241,474,53,799
"1001055932376387584",19,147,44,8,218
"1001085207825534976",29,239,845,126,1239
"1001099771602456576",8,102,158,27,295
"1001103028626345984",13,118,95,15,241
"1001108964216537089",17,166,205,35,423
"1001149367271686145",10,89,33,7,139
"1001149793496977408",11,120,52,11,194
"1001151001699803138",10,149,91,12,262
"1001212077699149825",22,252,166,35,475
"1001220050995511298",19,209,237,68,533
"1001404640796336128",22,244,102,25,393
"1001410457092218880",17,116,37,8,178
"1001415199516254208",13,152,121,17,303
"1001417880116891650",23,183,206,26,438
"1001420270094168064",14,138,188,25,365
"1001424695126880258",27,212,330,41,610
"1001455721588969472",39,271,485,91,886
"1001807174249713664",18,119,66,7,210
"1001807204519997442",17,126,65,17,225
"1001807216297627648",20,108,200,21,349
"1001834394359877633",17,144,268,42,471
"1001848460881035265",62,410,930,139,1541
"1001873279597064194",11,94,14,6,125
"1001873868498325504",18,148,38,18,222
"1001875884142362625",14,117,24,6,161
"1001973090107248641",11,105,56,9,181
"1001978774219644929",15,99,56,10,180
"1002023477531070464",21,181,151,23,376
"1002027245131661312",20,132,127,26,305
"1002141448232493056",24,192,171,45,432
"1002156016060989445",25,191,257,39,512
"1002159087830827008",19,160,204,35,418
"1002160516733853696",16,126,519,57,718
"1002176736761655298",16,128,55,12,211
"1002177521599860736",37,352,378,92,859
"1002298565299965953",24,128,205,44,401
"1002506360351846400",19,204,339,66,628
"1002508937445478402",26,246,582,74,928
"1002510522032541701",11,88,139,30,268
"1002539852171304960",19,128,155,37,339
"1002666307043647489",16,130,55,13,214
"1002877499448152065",10,128,90,15,243
"1002884227753480193",14,197,167,26,404
"1002892787803676673",19,168,217,31,435
"1002946237652504576",7,45,17,5,74
"1002950189668360192",10,92,34,8,144
"1002951786301415424",8,50,79,10,147
"1002954515941941249",11,128,106,14,259
"1002968869043097600",9,155,266,37,467
"1002971013313908738",23,269,95,37,424
"1003017786355015680",13,150,100,29,292
"1003024268756733952",18,215,137,38,408
"1003259934417580033",23,251,117,32,423
"1003266374473519105",18,174,218,27,437
"1003268646070874113",24,160,260,36,480
"1003328970069331968",27,251,231,40,549
"1003601217111707649",22,233,280,70,605
"1003611857272360960",16,147,87,10,260
"1003612459855466497",10,96,58,19,183
"1003616210922147841",36,139,736,84,995
"1003617811254710273",9,107,31,9,156
"1003618276293988352",9,95,65,4,173
"1003634405036961793",25,164,68,19,276
"1003637916919320577",16,143,283,27,469
"1003714332973322240",14,107,127,13,261
"1003738642903420928",15,150,199,29,393
"1003738744061603843",15,136,171,18,340
"1003806272360239104",9,88,101,13,211
"1003832766511894528",32,212,437,112,793
"1003949263481696256",20,171,153,38,382
"1003952348962619392",10,121,64,12,207
"1003956743133650944",17,137,183,22,359
"1003960114989207552",13,87,103,18,221
"1003962584352030720",22,136,285,45,488
"1003963157734453249",11,90,45,13,159
"1003967400130285569",8,57,43,6,114
"1003969399148118016",18,145,386,42,591
"1003985427970314246",11,118,73,30,232
"1003987298072002565",19,155,69,17,260
"1003995933540044800",20,181,182,18,401
"1003997350791188482",7,75,42,7,131
"1003998873004773376",11,92,91,8,202
"1004092104488947719",18,160,64,11,253
"1004092260475162624",22,177,193,25,417
"1004100003185426432",8,81,69,6,164
"1004160401658073090",19,231,109,23,382
"1004166633349361664",11,100,85,10,206
"1004171953404628998",12,157,72,16,257
"1004172786359848960",24,170,289,34,517
"1004174436759691266",14,129,213,34,390
"1004211778837012481",17,159,168,18,362
"1004351340041199616",19,152,126,30,327
"1004356576671666179",6,75,32,5,118
"1004359335399641089",24,198,228,52,502
"1004360833407815680",20,178,147,32,377
"1004363400674234368",14,179,112,18,323
"1004373239194320900",12,109,113,12,246
"1004447235046862850",11,124,68,11,214
"1004455146867306496",12,126,32,10,180
"1004478326336040960",14,83,113,9,219
"1004693718945984512",18,149,261,35,463
"1004696266297827328",21,143,31,14,209
"1004710919853760512",19,167,68,14,268
"1004711557291560960",18,133,140,17,308
"1004722061808427008",18,135,146,22,321
"1004724915562598400",7,60,26,1,94
"1004726490058182656",26,271,92,41,430
"1004742470700322816",19,114,374,143,650
"1004743621587894272",30,231,169,27,457
"1004750401709715457",30,239,120,50,439
"1004752258955988992",10,87,38,9,144
"1004752551034654720",10,86,28,7,131
"1004775164834349061",7,62,18,1,88
"1004813164066766848",6,65,12,1,84
"1004814196247318528",9,76,19,3,107
"1004815794365255680",7,71,19,4,101
"1004846478253273088",20,161,201,28,410
"1004871827406061573",27,222,218,52,519
"1004909785547001856",20,203,108,23,354
"1005028243760611328",19,248,102,32,401
"1005030839019802625",25,211,68,26,330
"1005033088202756097",13,126,88,23,250
"1005045008746057728",25,161,75,16,277
"1005047468705439744",14,126,219,37,396
"1005304018741035008",13,144,33,8,198
"1005479740000624640",8,73,46,12,139
"1005548570332631040",10,155,32,5,202
"1005550889422110721",16,122,31,10,179
"1005554263601250304",9,94,36,4,143
"1005554268009422849",10,89,24,4,127
"1005554429087514624",16,262,79,29,386
"1005554687678922752",15,186,63,24,288
"1005554692133249026",12,120,44,13,189
"1005979207544000512",16,204,143,40,403
"1005982266496094209",26,278,126,48,478
"1005985339121504256",19,194,88,20,321
"1005988633747312640",25,231,93,31,380
"1005989290520739845",15,137,100,43,295
"1006003345360908295",24,261,193,40,518
"1006081372912484353",11,122,33,5,171
"1006286790536323074",16,174,54,23,267
"1006293144911085568",24,268,109,31,432
"1006296018210603008",28,255,317,59,659
"1006326057375584261",23,178,144,16,361
"1006334219759575040",43,201,118,90,452
"1006446738016755712",32,258,116,42,448
"1006619872367804416",11,120,45,6,182
"1006630395067039744",14,142,56,11,223
"1006637373629722624",11,143,51,23,228
"1006637378088284160",16,121,65,16,218
"1006640689843560448",0,0,368,81,449
"1006640694264397824",0,0,124,31,155
"1006648161538961408",18,122,55,14,209
"1006681862301933568",8,104,46,11,169
"1006688157096501248",18,130,37,15,200
"1006690543403855872",14,137,45,15,211
"1006694541083021312",29,222,114,20,385
"1006706273746735105",28,232,136,51,447
"1006832813499269120",11,96,19,4,130
"1006833565022031873",12,117,71,22,222
"1006833568641777664",7,93,28,17,145
"1006837459794251776",10,127,87,7,231
"1006837823469735936",21,150,236,41,448
"1006839007492308992",20,217,185,33,455
"1006856219200548864",16,143,144,15,318
"1006866089110892545",20,127,55,6,208
"1006866982833131520",18,133,88,27,266
"1006891643985854464",34,267,454,68,823
"1006992524366503941",19,188,136,20,363
"1006993862152392704",14,130,32,10,186
"1007002252467458048",12,112,54,5,183
"1007239837529800705",21,194,134,42,391
"1007278671097417729",11,125,113,14,263
"1007278701996802048",21,260,203,44,528
"1007278788009480192",24,232,266,44,566
"1007278825661784064",15,142,136,42,335
"1007300111481888768",9,122,46,10,187
"1007315424546091008",15,133,83,33,264
"1007572229935202304",14,183,152,50,399
"1007577375905861637",17,159,114,35,325
"1007580091692568576",11,107,87,24,229
"1007589800667435011",17,167,92,34,310
"1007591075601637376",8,97,128,33,266
"1007592042124513283",6,97,56,13,172
"1007594445104189441",12,114,112,15,253
"1007671131841671169",22,228,626,74,950
"1007679422865006593",20,181,505,59,765
"1007681553676283904",22,279,391,98,790
"1007745343306584064",18,126,127,18,289
"1007750530976927744",11,114,128,23,276
"1007972046666690561",20,249,550,67,886
"1007974129474121728",35,334,564,98,1031
"1007986538985197568",18,254,326,52,650
"1008316495733186560",13,135,103,34,285
"1008317842264088576",14,80,68,13,175
"1008326335083761664",12,118,74,10,214
"1008328413210398720",15,125,96,17,253
"1008330598363090944",15,109,92,15,231
"1008333717545410560",15,121,113,13,262
"1008335560988078080",12,109,99,22,242
"1008340100877570048",13,115,154,15,297
"1008362351807037441",19,216,414,72,721
"1008506045373845504",25,171,186,33,415
"1008510118395293699",16,165,151,36,368
"1008511869970255872",15,149,176,30,370
"1008515606751084544",27,200,238,60,525
"1008692333771132929",18,188,244,46,496
"1008696508697513985",23,156,278,36,493
"1008696952559734787",25,201,189,23,438
"1008708576628625408",34,207,386,55,682
"1008708634396721153",16,126,400,45,587
"1008709364939677697",21,171,606,68,866
"1008725438972211200",22,164,312,52,550
"1008732992481710081",11,154,310,26,501
"1009071326219395073",17,147,168,29,361
"1009071330661142533",14,102,220,23,359
"1009071378371313664",28,225,192,31,476
"1009071403918864385",25,218,644,66,953
"1009075083112050690",24,247,261,54,586
"1009076294615814145",16,154,238,32,440
"1009094070638084118",6,67,126,19,218
"1009127586528661504",9,61,44,5,119
"1009134789838843905",11,161,281,40,493
"1009241032100335616",24,178,379,44,625
"1009258943175168002",10,101,80,10,201
"1009263794361692160",18,70,119,22,229
"1009411866475532288",24,243,327,67,661
"1009431025817092097",29,193,318,65,605
"1009435777992884227",19,167,189,32,407
"1009450868641497094",9,71,67,10,157
"1009490487051513861",11,70,93,20,194
"1009527495043923968",10,64,176,14,264
"1009534957440516096",13,99,102,27,241
"1009536237881847808",60,606,300,89,1055
"1009555147108696064",7,62,55,6,130
"1009579307847553024",14,146,106,26,292
"1009602111133442048",13,104,73,11,201
"1009638183091359744",15,135,112,14,276
"1009644987544408064",14,139,78,20,251
"1009770941604298753",19,205,122,34,380
"1009775416456941568",15,134,93,24,266
"1009777520659652609",19,136,66,11,232
"1009780708381024258",14,90,89,15,208
"1009785143635206149",20,182,155,32,389
"1009796154220072960",8,67,39,3,117
"1009807715798044672",23,187,275,39,524
"1009844059211366401",22,134,174,25,355
"1009895079631351808",9,93,58,7,167
"1009900144861634561",8,74,30,3,115
"1009900306694656002",17,122,46,13,198
"1009900449456115719",10,107,77,20,214
"1009916650622251009",36,297,795,101,1229
"1010110544605581312",13,161,152,19,345
"1010113882344558592",17,164,102,24,307
"1010115331380203520",24,241,223,33,521
"1010116816998490113",22,200,228,36,486
"1010123101684883457",10,99,40,3,152
"1010126805850902528",13,112,42,8,175
"1010129956222001153",18,240,88,22,368
"1010153153084428288",23,171,96,26,316
"1010156224749408258",28,246,316,51,641
"1010163024173457409",13,101,88,15,217
"1010166772912320513",0,0,106,14,120
"1010246126820347906",19,244,209,38,510
"1010257002478620673",16,204,161,33,414
"1010320166486454272",17,128,95,18,258
"1010481479279923201",9,90,31,3,133
"1010485876806348800",17,172,214,39,442
"1010486772541816834",13,112,230,35,390
"1010502249263624195",13,152,57,12,234
"1010503423773507584",11,100,49,7,167
"1010505990259855361",20,256,191,26,493
"1010522933498806278",6,79,58,1,144
"1010522945402224642",5,67,44,3,119
"1010536329766006784",12,128,16,5,161
"1010567610352611328",12,117,82,12,223
"1010569562138406912",27,302,319,69,717
"1010571197271011328",17,156,71,12,256
"1010619779600642048",11,56,42,7,116
"1010645413576126464",15,123,78,15,231
"1010699954157830144",22,212,146,27,407
"1010873383087636480",25,238,292,46,601
"1010900865602019329",24,215,507,74,820
"1010978975391322112",20,221,122,23,386
"1011036519812030467",21,143,333,49,546
"1011038477889175553",16,245,160,34,455
"1011053439575576576",12,115,63,8,198
"1011209592670425088",17,144,104,10,275
"1011212766487728133",36,250,775,115,1176
"1011218033216512005",17,236,206,62,521
"1011226622324887556",21,196,146,30,393
"1011228265003077632",19,154,128,39,340
"1011231137233080321",17,151,127,25,320
"1011256862975676416",18,123,34,15,190
"1011295779422695424",42,303,540,121,1006
"1011360410648416258",17,145,229,29,420
"1011389124475961345",17,202,193,37,449
"1011391230188457984",26,307,239,55,627
"1011394762979586049",6,60,70,16,152
"1011422555947712513",10,112,78,9,209
"1011568906992017408",13,128,71,12,224
"1011571026034089984",12,111,65,11,199
"1011574256117993472",8,100,89,16,213
"1011577303023980544",9,93,52,9,163
"1011579076493144065",9,126,38,9,182
"1011584315040419840",25,134,312,52,523
"1011588967442022406",18,184,182,37,421
"1011602664143106048",18,229,202,41,490
"1011620271327989760",26,257,239,68,590
"1011703668721246209",12,120,43,13,188
"1011789419521675264",9,98,15,6,128
"1011792563425116161",12,118,25,7,162
"1011795883925663744",35,179,433,49,696
"1011803149911384064",17,140,121,18,296
"1011805006390071304",14,111,87,29,241
"1011806195462688768",5,37,34,4,80
"1011819474574561283",9,84,86,25,204
"1011931656230526976",37,321,239,44,641
"1011952266268545024",29,170,221,28,448
"1011975204778729474",23,212,94,30,359
"1011994162076573697",19,142,201,38,400
"1012026033418076160",11,86,29,4,130
"1012051330591023107",8,90,41,19,158
"1012070304091435010",14,121,29,5,169
"1012082654370336768",12,76,17,1,106
"1012169482272460800",14,142,59,9,224
"1012174975061647360",15,169,76,10,270
"1012174976668061699",16,156,65,12,249
"1012290012279435265",19,136,83,16,254
"1012295859072126977",23,175,389,57,644
"1012297599431401474",9,77,29,8,123
"1012299239207198721",9,97,83,11,200
"1012312287280074754",23,171,122,30,346
"1012315534220808192",26,152,335,33,546
"1012318771250384896",20,133,138,19,310
"1012321218056384513",14,109,55,5,183
"1012409641911930881",21,164,62,12,259
"1012412743520047111",12,84,67,10,173
"1012437964373123072",16,139,445,32,632
"1012757431124930562",10,87,119,15,231
"1012759156426670083",16,140,152,27,335
"1012840647743737857",15,125,42,14,196
"1013016168377081856",23,209,224,43,499
"1013019990340046849",29,317,167,43,556
"1013023608040513537",26,275,183,46,530
"1013037916216614912",19,185,107,34,345
"1013136536576188416",9,135,147,10,301
"1013139532290625538",16,113,128,15,272
"1013141673776500736",17,172,119,19,327
"1013143055417905152",8,70,103,8,189
"1013146187510243328",27,275,405,64,771
"1013391783533989888",4,58,94,13,169
"1013394559429169152",16,231,329,52,628
"1013507396558303233",16,193,123,40,372
"1013618640061595648",34,148,146,34,362
"1013902140409040897",11,91,38,7,147
"1013976609290964997",20,221,236,50,527
"1014090584963866624",12,147,248,37,444
"1014092792329535488",10,101,54,15,180
"1014094834863362049",9,99,88,10,206
"1014098721460686849",13,164,130,28,335
"1014100908127543296",14,152,139,18,323
"1014105549624037377",21,137,256,29,443
"1014117468858650624",17,219,262,54,552
"1014146835135516672",22,131,221,32,406
"1014151457954811904",21,203,211,26,461
"1014257237945176071",0,0,322,40,362
"1014258987422928896",5,78,48,9,140
"1014261296240488450",16,153,259,31,459
"1014272859408162816",0,0,22,5,27
"1014287566386888709",11,75,25,4,115
"1014295751814533120",14,140,38,9,201
"1014295759393644545",9,105,52,7,173
"1014306963243532296",14,162,121,20,317
"1014519862482407424",37,323,305,78,743
"1014520426842738689",16,167,99,20,302
"1014611307427966976",20,216,139,29,404
"1014702302408642562",21,258,87,26,392
"1014873774003556354",18,153,74,40,285
"1014875575557804034",17,152,186,47,402
"1014875894614319104",23,191,186,47,447
"1014956568129892352",47,115,265,30,457
"1014956573095915520",15,79,98,10,202
"1015025320657743872",9,108,82,16,215
"1015033658548207616",21,246,432,49,748
"1015037322226642944",17,235,168,28,448
"1015039273987264517",21,199,394,59,673
"1015267193720852488",18,152,123,27,320
"1015278594795417600",25,249,276,54,604
"1015586529484443648",22,196,494,87,799
"1015587406374932480",14,133,114,46,307
"1015697664514674689",19,215,450,34,718
"1015723140364865536",23,278,482,82,865
"1015947163292008451",17,165,208,23,413
"1016056693791346688",28,271,78,19,396
"1016071245568380934",22,177,143,37,379
"1016079192604139520",82,663,239,153,1137
"1016289620596789248",15,128,79,13,235
"1016291887957848066",13,109,60,12,194
"1016294574417956869",20,159,139,39,357
"1016327387154395138",20,138,289,27,474
"1016367395294908421",29,169,175,22,395
"1016368503723577344",30,197,166,40,433
"1016447571563249666",10,107,31,16,164
"1016515895735267328",11,135,51,18,215
"1016616792926703616",10,127,87,12,236
"1016633811378073602",8,98,37,10,153
"1016638035281219584",16,211,203,48,478
"1016663151935291393",27,241,70,18,356
"1016693575344504832",19,194,226,31,470
"1016695860267134976",11,78,54,8,151
"1016729137409486853",15,141,137,22,315
"1016754517415624704",16,168,216,28,428
"1016757033071079424",22,167,105,20,314
"1016956445307400193",14,135,128,26,303
"1017025845905494016",16,142,96,12,266
"1017025848409550848",12,114,67,9,202
"1017086416176730112",18,169,127,20,334
"1017093020783710209",20,211,172,30,433
"1017153813625626624",12,159,151,26,348
"1017164990099415041",21,185,201,41,448
"1017190186269184001",13,139,102,16,270
"1017286281867481089",19,143,83,26,271
"1017288317342224384",11,120,66,11,208
"1017290478839050240",13,135,88,16,252
"1017362207426908160",10,74,41,2,127
"1017411426237861890",9,88,54,22,173
"1017426065029910529",16,132,83,10,241
"1017446575474335744",20,151,158,21,350
"1017466758280679425",18,156,188,26,388
"1017650505043140609",22,167,135,25,349
"1017772506470649857",7,79,106,14,206
"1017832276615417858",8,143,118,30,299
"1018062211909083136",9,88,33,26,156
"1018068353305411584",17,106,229,25,377
"1018069319702458368",15,178,71,18,282
"1018072081676865536",26,194,130,37,387
"1018074723140427776",34,314,549,78,975
"1018093807060045824",17,143,243,46,449
"1018096402520518656",16,133,231,26,406
"1018113905716027393",7,91,32,5,135
"1018197842559725569",28,306,408,61,803
"1018528420093878272",23,212,142,26,403
"1018530167902228480",13,125,194,22,354
"1018530173006692352",12,90,142,17,261
"1018530179549822977",10,99,247,39,395
"1018541464416997376",25,131,160,21,337
"1018727890345693184",17,163,237,32,449
"1018731223890481153",36,255,331,48,670
"1018738368753078273",28,154,513,47,742
"1018781525309943808",6,91,55,2,154
"1018890862653157381",11,91,194,19,315
"1018900904735531014",13,117,168,15,313
"1018943446583668736",29,227,690,93,1039
"1018955906690584576",26,225,287,53,591
"1018956970143858688",16,161,360,53,590
"1019218575691837443",17,169,239,42,467
"1019225830298456066",26,162,507,72,767
"1019228676460773377",15,160,166,31,372
"1019230023897833479",20,177,385,48,630
"1019376680572456960",23,163,420,63,669
"1019378119671730176",21,243,211,37,512
"1019434161889796097",16,193,211,30,450
"1019520574371123200",19,155,496,46,716
"1019524328927453184",10,135,115,22,282
"1019526399542091776",9,131,102,16,258
"1019533312052858880",12,99,74,8,193
"1019538038651871233",11,134,115,10,270
"1019544304853966853",26,222,506,71,825
"1019545713435467776",15,180,167,24,386
"1019664477162278918",19,201,140,11,371
"1019695583853010944",13,136,49,9,207
"1019695889626083331",24,208,177,35,444
"1019757603570806785",30,281,122,32,465
"1019890400029499393",12,115,36,5,168
"1019891915402203139",14,148,65,9,236
"1019894101116948480",18,200,231,56,505
"1019899507910283264",19,159,212,37,427
"1019903123312308224",10,140,132,20,302
"1019909066456489986",10,81,90,20,201
"1019932691339399168",21,174,207,31,433
"1019936133147516929",20,180,392,47,639
"1019937445356474368",12,119,94,17,242
"1019938748413435910",16,116,176,18,326
"1020008975922810883",30,303,299,43,675
"1020285014616002560",14,120,27,4,165
"1020287981020729344",14,120,63,12,209
"1020290163933630464",16,134,102,36,288
"1020293430398935040",16,148,115,17,296
"1020316352140185600",7,90,53,6,156
"1020425741664751616",28,258,449,88,823
"1020432499082702849",29,237,917,152,1335
"1020642287725043712",32,310,1219,151,1712
"1020811550771294211",18,199,119,20,356
"1020978929736265729",28,198,182,35,443
"1020984152357777408",32,275,393,57,757
"1021007656511852544",22,282,179,39,522
"1021016070134648833",24,163,182,23,392
"1021020863733420032",19,174,438,61,692
"1021137490252640258",5,79,32,7,123
"1021158915206152193",36,333,596,80,1045
"1021234525626609666",86,557,872,162,1677
"1021337592904732672",7,56,46,3,112
"1021341698734030848",32,236,227,43,538
"1021347230022807552",27,202,101,38,368
"1021349516878974977",26,176,115,23,340
"1021351630648815616",21,159,157,24,361
"1021370601863294977",26,184,237,39,486
"1021380986452545537",26,208,134,19,387
"1021384752136409088",16,141,178,34,369
"1021388295618682881",16,122,281,43,462
"1021569559537610752",10,86,23,4,123
"1021577620796964870",19,125,107,13,264
"1021755459416543238",32,216,209,39,496
"1021836311307661312",9,80,80,13,182
"1021886118315393024",8,86,52,8,154
"1021917767467982854",17,161,179,20,377
"1021924262045802496",22,189,209,21,441
"1022224319336726528",16,143,53,15,227
"1022672169019613186",18,176,81,9,284
"1022690767305928704",17,158,93,19,287
"1022805381440069632",16,145,110,23,294
"1022808452677160960",22,171,200,39,432
"1022812910702215169",24,147,452,65,688
"1022877332858650624",20,181,85,22,308
"1022908672756801536",14,113,27,2,156
"1022925366669856769",9,123,74,13,219
"1023007120130760704",24,218,225,32,499
"1023023685681250304",16,119,94,18,247
"1023534604148518912",12,144,186,38,380
"1023546197129224192",14,139,246,30,429
"1023653191974625280",28,238,531,75,872
"1023662510371741696",20,189,387,53,649
"1023664624259014656",22,194,297,50,563
"1023982166781448193",7,69,34,3,113
"1024014645940633601",10,79,28,4,121
"1024042102886465536",8,100,81,18,207
"1024245909239021568",12,122,119,23,276
"1024263146008207361",22,131,436,42,631
"1024264286418489345",19,75,185,36,315
"1024287257975566338",17,175,310,54,556
"1024347406887014404",29,189,111,39,368
"1024347409483292672",14,129,91,8,242
"1024394107404279808",12,138,97,12,259
"1024641683600879616",24,161,109,12,306
"1024644767924334593",17,137,75,11,240
"1024646945640525826",28,200,703,68,999
"1024649463435067398",21,187,214,30,452
"1024656465158721536",20,168,290,44,522
"1024680095343108097",20,150,320,34,524
"1024685313778741250",19,174,201,19,413
"1024730466530865152",12,125,93,8,238
"1024765763775815695",11,98,57,14,180
"1024860399458508800",13,149,35,6,203
"1024877011775500290",10,135,110,16,271
"1024974107337781248",22,148,249,36,455
"1025177042470535168",16,141,121,22,300
"1025435905736228864",5,64,24,2,95
"1025577505615503360",9,98,98,10,215
"1025584134322892800",11,136,72,14,233
"1025586524782559232",62,249,1290,200,1801
"1025725493373558784",10,123,94,7,234
"1025728712560594946",14,168,125,17,324
"1025763007840886790",10,95,51,10,166
"1025840837358432256",4,52,112,27,195
"1025901304047198209",9,102,58,8,177
"1026069857589227520",30,210,603,73,916
"1026084333315153924",31,129,697,69,926
"1026086905539174400",20,201,199,39,459
"1026087766071947265",19,157,367,37,580
"1026196465696350208",30,223,399,71,723
"1026471244949061632",14,185,227,26,452
"1026474458326986752",14,129,152,23,318
"1026524292396273664",16,178,202,34,430
"1026546879289425920",15,140,55,9,219
"1026585401874677760",21,192,184,25,422
"1026587142989008897",12,143,319,37,511
"1026781688167366656",17,168,134,18,337
"1026897064066777099",14,151,106,15,286
"1027211440225243137",26,285,203,52,566
"1027214330503352320",16,154,210,36,416
"1027266105797238791",30,242,371,70,713
"1027545694201159680",21,198,263,47,529
"1027585937163931648",20,213,410,75,718
"1027586174448218113",55,245,443,72,815
"1027899286586109955",22,173,128,26,349
"1028030912095838208",24,233,201,37,495
"1028269087133257728",20,171,116,24,331
"1028269328246947840",17,199,266,58,540
"1028271447632957441",36,234,359,33,662
"1028347518822825984",17,184,144,22,367
"1028354010129027077",20,233,239,60,552
"1028618150944944129",15,168,234,38,455
"1028633682918166528",21,242,252,49,564
"1028996374174593025",22,148,259,53,482
"1029002242932834310",17,131,200,32,380
"1029010124881453056",21,177,350,76,624
"1029022897787084800",12,94,78,13,197
"1029036065158557701",25,174,139,35,373
"1029037282676957185",22,218,131,53,424
"1029038164248338432",19,105,201,33,358
"1029069948214288384",13,76,82,10,181
"1029089559710236672",5,83,42,8,138
"1029183344397955074",17,127,253,23,420
"1029185314752000007",9,117,138,22,286
"1029321624603054080",16,142,79,14,251
"1029323499226243072",8,105,57,4,174
"1029325115547369472",9,109,70,8,196
"1029329583672307712",24,124,652,93,893
"1029335579845115904",8,127,77,17,229
"1029338578239795200",15,160,212,33,420
"1029352395464224769",18,178,157,27,380
"1029354577559281665",20,164,226,36,446
"1029355952414371841",14,174,200,25,413
"1029731513573822464",9,145,215,32,401
"1029733227404189697",6,113,83,12,214
"1029743849160232960",16,124,141,46,327
"1029895689868853248",16,178,187,31,412
"1029899109749202944",18,187,138,15,358
"1029911186949767168",34,263,133,52,482
"1029918661165936641",18,263,96,17,394
"1029920861128720385",22,208,296,58,584
"1030074380397752320",20,160,295,37,512
"1030091812495654912",13,121,181,18,333
"1030094399362007040",28,245,428,57,758
"1030116078125568006",34,165,203,21,423
"1030163121678245889",9,73,71,7,160
"1030237078586617856",13,158,104,19,294
"1030239036093411328",8,131,56,9,204
"1030241273784020993",12,150,97,20,279
"1030254224330969090",12,155,132,18,317
"1030257073047658501",19,209,212,44,484
"1030270284245467136",12,164,121,17,314
"1030433779112923136",11,152,106,15,284
"1030456820417081344",18,145,182,29,374
"1030536206415802369",13,123,148,38,322
"1030536210194882561",6,81,78,8,173
"1030582354308411392",15,212,152,37,416
"1030631977135812610",11,158,105,20,294
"1030632303507243008",7,130,132,12,281
"1030777074959757313",29,212,225,40,506
"1030779412973846529",21,208,203,46,478
"1030781399920455681",20,167,136,15,338
"1030804685136035841",25,200,453,61,739
"1031134125602820096",21,131,266,19,437
"1031137499995930624",14,139,162,20,335
"1031141396776984576",22,232,297,40,591
"1031150465759633408",26,182,204,31,443
"1031152483949838336",16,173,186,24,399
"1031154974942810114",23,193,414,45,675
"1031503298967363586",15,125,409,36,585
"1031505811074412544",17,149,193,36,395
"1031508193107763200",26,161,292,24,503
"1031544711717302272",26,221,218,45,510
"1031547390644420613",20,191,185,48,444
"1031550517552603138",16,154,155,32,357
"1031553002371522561",17,135,118,12,282
"1031724100719403009",22,143,242,54,461
"1031852996567748613",27,198,238,30,493
"1031857204767453184",15,123,140,28,306
"1031861173149413376",17,105,122,25,269
"1031907600219209728",20,137,219,22,398
"1032247043992023040",105,193,719,110,1127
"1032256443985084417",35,186,526,88,835
"1032259660378779648",18,85,330,35,468
"1032260490439864320",31,210,551,64,856
"1032282621290704897",15,85,68,5,173
"1032431371728445441",33,269,455,91,848
"1032495180530835456",29,179,788,93,1089
"1032709326643843072",11,105,97,21,234
"1032845356801974272",11,110,179,29,329
"1032934937962442754",24,228,290,47,589
"1032937718219714560",23,199,200,44,466
"1032948187416416256",22,210,205,35,472
"1032954224529817600",36,319,405,73,833
"1033023735517863936",11,82,127,20,240
"1033045273361178624",13,108,160,20,301
"1033045274866999297",8,71,44,4,127
"1033045280143355904",9,72,116,10,207
"1033133359185055745",4,83,43,7,137
"1033147164812300288",6,77,80,9,172
"1033148759084093440",8,87,73,3,171
"1033152062203342850",13,135,48,6,202
"1033175432651321345",8,82,76,8,174
"1033196105159372800",15,88,55,10,168
"1033327353227882496",21,148,188,24,381
"1033332301579661312",21,180,238,44,483
"1033334753003536384",12,145,219,32,408
"1033339636343549952",31,277,483,97,888
"1033341088579440640",27,227,248,42,544
"1033341788491317255",25,193,240,45,503
"1033343857675644928",22,158,148,34,362
"1033500723709992960",24,181,135,28,368
"1033515425336885248",67,336,908,108,1419
"1033722550881329152",14,131,100,23,268
"1033723516116500481",15,155,172,18,360
"1033836873473568768",20,208,503,59,790
"1033876658439245825",40,298,859,110,1307
"1034062375941550081",15,158,129,12,314
"1034072454086447104",25,236,176,36,473
"1034072800041099265",12,121,121,20,274
"1034128239579549696",12,136,121,19,288
"1034128472946434056",14,157,69,16,256
"1034128943480299521",11,153,123,16,303
"1034141327666163712",13,107,112,15,247
"1034200842868383744",13,99,65,13,190
"1034248860116430848",9,148,74,20,251
"1034378693370630145",11,153,264,23,451
"1034379525113753601",18,186,82,26,312
"1034445783876161536",16,167,121,24,328
"1034456273306243076",22,156,331,55,564
"1034456281120206848",12,116,243,41,412
"1034492929153359872",7,134,65,10,216
"1034543787593347072",9,79,47,7,142
"1034599532787630080",13,157,43,14,227
"1034603586817339392",14,129,43,9,195
"1034610829860261895",33,276,243,54,606
"1034612092253470721",12,119,112,21,264
"1034626683066826753",16,148,77,17,258
"1034628350986338308",19,177,269,50,515
"1034654816046329856",26,223,294,43,586
"1034663158357655552",10,111,45,12,178
"1034772809350885376",10,151,190,22,373
"1034775835004358656",8,198,218,37,461
"1034777225336369152",13,145,144,14,316
"1034778515789545473",7,159,101,15,282
"1034782741714399232",19,211,170,31,431
"1034783131855998976",21,242,395,48,706
"1034785759377727490",8,114,57,3,182
"1034810550025433090",21,85,92,5,203
"1034817106632761344",9,147,80,13,249
"1034821067423014913",20,178,364,55,617
"1034907478566359041",24,230,361,47,662
"1034914371099676674",14,102,61,5,182
"1034914376141168640",5,67,15,0,87
"1034914377768620037",5,73,28,0,106
"1034914379391807488",5,79,51,4,139
"1034965029676883970",17,155,83,12,267
"1034979892524457985",15,159,106,11,291
"1034981992692166658",16,155,78,12,261
"1034990940593823746",15,146,118,15,294
"1035117507839967232",26,175,221,33,455
"1035120511259500544",28,133,337,29,527
"1035122954697433088",30,204,557,90,881
"1035125176617365504",16,145,100,15,276
"1035131133997068288",19,134,213,18,384
"1035134150590783489",17,128,124,11,280
"1035148684432953346",16,224,222,33,495
"1035154621357064192",11,86,214,23,334
"1035159956507566080",11,97,101,12,221
"1035162684633825286",12,141,132,21,306
"1035209068095434752",21,229,302,50,602
"1035233203609657344",14,154,105,14,287
"1035255721951035392",16,174,216,49,455
"1035344085798801408",12,140,186,23,361
"1035575198169411584",22,252,439,52,765
"1035597354395680774",19,179,307,66,571
"1035650292782653441",6,101,109,13,229
"1035678961349668864",9,98,58,9,174
"1035715271418413056",16,157,276,29,478
"1035717747936768000",10,92,92,9,203
"1035718119459893250",3,75,27,11,116
"1035718986871320577",11,103,209,36,359
"1035849517873201157",8,128,83,7,226
"1035850173224824832",9,101,168,19,297
"1035866602623979526",10,149,190,16,365
"1035868119884021760",6,121,95,9,231
"1035879783547199488",10,158,291,32,491
"1035881733898547201",13,181,185,43,422
"1035905988682018816",18,161,255,27,461
"1035908242277376001",12,145,204,30,391
"1036052758389051392",20,173,189,33,415
"1036054534450229250",12,124,74,8,218
"1036056454954995712",17,162,129,15,323
"1036061566628757504",18,167,243,27,455
"1036244434164310016",19,189,165,25,398
"1036246829560680454",15,238,253,24,530
"1036576599771111424",15,229,165,40,449
"1036590520649306113",16,164,178,28,386
"1036637078640058368",11,119,110,13,253
"1036672676801196036",8,121,185,32,346
"1036681588573130752",25,140,446,68,679
"1036685082650705920",18,164,182,30,394
"1036689178749227008",16,185,245,41,487
"1036695682072158214",13,162,199,20,394
"1036740691211284480",18,159,98,23,298
"1036991866124861440",31,183,257,45,516
"1037043834482552832",11,91,43,7,152
"1037077962632450050",11,96,31,6,144
"1037078251095687174",21,171,120,23,335
"1037078254845390849",13,135,98,9,255
"1037079053784821766",5,80,28,3,116
"1037081791599915008",11,118,35,8,172
"1037083839238164486",8,124,101,13,246
"1037117638101688320",17,163,347,35,562
"1037171035152506880",24,194,159,41,418
"1037173907625832448",23,158,290,38,509
"1037181592068911104",8,86,60,7,161
"1037182409446490112",10,114,99,7,230
"1037302649199177728",23,178,564,82,847
"1037329592074350592",23,184,345,50,602
"1037329782671859712",9,100,63,7,179
"1037334510159966214",19,184,414,68,685
"1037337422860873731",13,107,80,10,210
"1037338204695941120",13,107,163,11,294
"1037417543017877506",8,113,103,19,243
"1037447783593254913",8,67,38,7,120
"1037456816601485316",24,148,275,45,492
"1037464177269514240",59,176,908,115,1258
"1037485664433070080",30,237,690,107,1064
"1037541538950209537",54,380,467,106,1007
"1037656324010663937",28,175,345,45,593
"1037661562897682432",33,260,260,55,608
"1037664539284844545",13,138,124,17,292
"1037704356861276160",16,202,151,29,398
"1037751332860555264",8,80,92,17,197
"1037841708816318466",7,96,43,9,155
"1037869794672799744",13,130,59,9,211
"1037892820126683136",10,129,101,18,258
"1037895240365928448",8,121,72,11,212
"1038018199449567232",23,163,427,77,690
"1038022020691161088",10,127,44,4,185
"1038027233519001600",31,223,554,76,884
"1038103589904777218",20,227,160,55,462
"1038159042751983616",9,111,90,18,228
"1038180008479608832",12,141,223,19,395
"1038437927506923521",8,135,71,6,220
"1038438594543845378",12,110,141,16,279
"1038439687252307969",13,176,102,26,317
"1038453273286664193",20,183,216,35,454
"1038534611880603650",13,107,273,27,420
"1038579619195224064",14,141,51,10,216
"1038602549971116032",15,166,87,16,284
"1038604758582484993",18,221,294,64,597
"1038605665168764928",13,142,54,10,219
"1038774320972095488",20,190,149,33,392
"1038782091629088768",9,179,197,28,413
"1038786434306650113",14,143,83,5,245
"1038789398140084224",23,225,110,31,389
"1038792215617830912",9,140,111,13,273
"1038799859128696833",20,170,430,59,679
"1038809595219791872",7,142,82,7,238
"1038812262549663744",7,125,123,22,277
"1038841536316944386",10,125,68,6,209
"1039107129880272896",17,180,163,29,389
"1039108838262284289",13,122,101,15,251
"1039111866956566528",13,116,261,35,425
"1039115242465374208",12,108,154,22,296
"1039117933623078912",10,91,101,19,221
"1039130589406875651",12,115,147,11,285
"1039150829754888193",10,159,217,31,417
"1039162221492928513",32,315,219,59,625
"1039235839333679105",26,136,84,10,256
"1039237395374325760",36,202,165,29,432
"1039261826318524417",22,229,174,34,459
"1039270337198927873",7,98,80,9,194
"1039291783031734273",28,172,118,27,345
"1039292858715578374",16,115,73,23,227
"1039296436809154563",20,231,135,50,436
"1039470755816374272",17,150,216,32,415
"1039471746120908801",6,128,30,4,168
"1039473456709021696",15,167,140,60,382
"1039479054930530304",12,98,108,12,230
"1039483479363399680",22,201,177,17,417
"1039489954223542274",24,112,128,14,278
"1039498334594052096",18,110,360,46,534
"1039537164458053633",7,88,43,4,142
"1039556378766069760",6,105,67,11,189
"1039608725819088899",11,119,104,15,249
"1039669853060325378",6,105,49,9,169
"1039684040901779457",15,151,135,17,318
"1039687158456639489",15,111,81,16,223
"1039693872396468227",24,206,214,56,500
"1039823496501768192",12,133,156,23,324
"1039828966595616768",16,120,518,40,694
"1039830659504779265",17,113,64,4,198
"1039831904109948928",17,90,56,8,171
"1039875785853681664",14,102,40,7,163
"1039877857441402882",15,127,152,12,306
"1039915933278580738",22,127,75,11,235
"1040016355699949573",10,59,22,4,95
"1040017623017287699",7,82,35,10,134
"1040198906842427392",11,75,177,24,287
"1040203362652880896",9,58,37,10,114
"1040210045525536768",13,119,58,13,203
"1040211068973469696",9,70,40,10,129
"1040214866450178049",17,113,123,14,267
"1040217897703026689",34,121,810,93,1058
"1040220855400386560",30,139,626,73,868
"1040242677877551104",21,168,92,23,304
"1040257520026181634",9,72,26,6,113
"1040290603911794689",18,89,73,13,193
"1040294453586665472",8,63,10,1,82
"1040298233359200258",22,137,155,20,334
"1040407422156857344",33,266,252,92,643
"1040429268923236352",5,63,58,9,135
"1040575890139348992",15,136,92,17,260
"1040716938626965505",13,123,48,10,194
"1040717757107589126",4,74,28,1,107
"1040760021443850241",8,105,143,15,271
"1040763121571438592",13,128,29,24,194
"1040780813086928897",8,104,36,7,155
"1040783519423913984",10,95,184,21,310
"1040788151000883201",11,90,278,47,426
"1040799409670377472",15,165,418,78,676
"1041060770908393473",3,44,8,1,56
"1041064550605496321",6,90,71,15,182
"1041065107969777664",6,87,55,5,153
"1041067762452455424",4,84,58,8,154
"1041068591527993344",4,65,64,5,138
"1041086383505465345",16,131,354,44,545
"1041151464046043137",14,136,298,33,481
"1041330897948160002",22,166,554,74,816
"1041358333146525698",8,78,41,3,130
"1041438771366060034",18,82,123,11,234
"1041441676949184512",4,59,92,9,164
"1041451203442487297",18,163,332,43,556
"1041493551446675456",12,101,94,14,221
"1041628201435521024",10,81,86,9,186
"1041630722413527040",16,119,109,22,266
"1041631817697251328",7,123,146,18,294
"1041694123382726656",18,158,140,27,343
"1041697308780515328",21,215,180,47,463
"1041751173034848260",21,146,60,6,233
"1041754160599900161",5,82,84,18,189
"1041770673218236416",14,110,117,15,256
"1041792372085010432",7,80,38,10,135
"1041807304381870080",5,57,41,3,106
"1041810925450342401",7,166,42,8,223
"1041844539743498240",11,134,163,23,331
"1042030988518408194",18,139,92,10,259
"1042031772433883136",7,101,52,4,164
"1042033116695670786",11,136,89,14,250
"1042034269374361600",10,100,77,16,203
"1042042089779994629",6,114,22,6,148
"1042078523274485760",6,99,117,11,233
"1042078530413240320",1,70,87,8,166
"1042080802849390593",4,92,32,2,130
"1042116488881217537",11,124,94,18,247
"1042161534603063301",4,66,31,0,101
"1042197168533241856",9,81,136,15,241
"1042258387730399233",24,225,195,51,495
"1042263143496511488",17,151,44,10,222
"1042264934288175105",13,93,34,12,152
"1042376378593804289",8,125,118,14,265
"1042377919304269824",6,115,42,6,169
"1042378706747109376",17,153,111,19,300
"1042470708192919552",8,64,75,4,151
"1042558309813895168",8,106,54,19,187
"1042563390462418944",7,132,193,26,358
"1042576698007539714",9,116,50,8,183
"1042731410858168320",8,122,79,13,222
"1042733544466989057",12,110,51,16,189
"1042738383720726528",11,99,60,9,179
"1042739629139664896",9,86,42,7,144
"1042740913968164864",28,231,323,71,653
"1042768904857247744",18,141,75,20,254
"1042828275121369088",7,73,25,8,113
"1042830534513229825",7,71,29,6,113
"1042838322530398214",11,65,4,7,87
"1042838324187213824",7,55,15,3,80
"1042844399300952064",8,61,46,5,120
"1042894836024586240",5,78,62,10,155
"1042925680109924352",9,77,35,7,128
"1042948464408055808",5,70,57,13,145
"1042978990229606401",6,88,41,7,142
"1042980109907451905",6,85,27,6,124
"1042988257166819329",13,127,87,14,241
"1043121858797686785",19,239,242,39,539
"1043126336473055235",20,196,927,114,1257
"1043128595231604738",13,99,114,19,245
"1043130170612244481",13,122,317,57,509
"1043146627576258561",12,110,42,28,192
"1043148165883416576",11,120,92,28,251
"1043160312315146240",19,207,136,34,396
"1043188755866079232",5,75,77,9,166
"1043231338482921472",6,79,15,10,110
"1043241388580646912",7,60,40,11,118
"1043254590290911232",4,45,16,6,71
"1043305127250194432",8,87,27,8,130
"1043311845635833856",9,82,38,9,138
"1043339305593139200",18,171,97,25,311
"1043500433271066625",15,153,182,26,376
"1043514401477877766",13,87,82,15,197
"1043585537058181122",11,93,60,16,180
"1043964186034868224",19,130,62,18,229
"1043966388182953984",13,124,78,21,236
"1044229324075929600",6,62,24,2,94
"1044269053274193920",8,95,33,8,144
"1044326197424009223",6,51,7,1,65
"1044326708151820289",10,88,22,4,124
"1044339078257356801",19,147,172,43,381
"1044342304155348995",8,57,10,0,75
"1044371304395276288",7,65,21,1,94
"1044381661331410944",8,80,27,8,123
"1044415858465001472",31,212,287,33,563
"1044418753671417860",28,234,262,45,569
"1044537328415506432",11,143,95,9,258
"1044540438806482944",19,106,67,17,209
"1044575765109624832",18,107,173,26,324
"1044609366970814465",9,78,49,12,148
"1044626591463215104",9,117,95,10,231
"1044627015662538752",10,114,87,8,219
"1044628997999665153",23,231,149,26,429
"1044637590719221762",10,62,100,9,181
"1044669976672698373",7,72,70,2,151
"1044684820478119936",13,97,51,7,168
"1044709771629260801",9,84,111,18,222
"1044778309362622466",4,91,42,3,140
"1044782444321361920",29,273,263,37,602
"1044903153987203072",12,148,102,20,282
"1044903785125089281",11,145,83,17,256
"1044991766309621760",41,265,530,86,922
"1045001780092956672",13,124,60,10,207
"1045003711104331776",9,112,53,8,182
"1045052439521624067",8,120,80,10,218
"1045098909352235008",16,109,87,17,229
"1045832351211835392",38,336,314,121,809
"1046135994267963392",31,337,301,64,733
"1046136712987103241",11,97,86,29,223
"1046200796944191499",9,97,56,10,172
"1046201064469549056",10,119,65,27,221
"1046230634103025664",78,310,222,45,655
"1046443996074127361",40,341,330,71,782
"1046456403651698693",25,240,172,21,458
"1046473870650290176",27,283,202,66,578
"1046708836407685122",25,205,75,34,339
"1046714711268622336",15,114,32,3,164
"1046715439831797760",9,100,23,10,142
"1046733574173544448",9,72,73,11,165
"1046919122351792128",14,71,11,2,98
"1046922163457011712",7,96,23,7,133
"1046925327958708226",16,174,75,18,283
"1047137342924959744",8,78,22,8,116
"1047139656066842625",11,101,37,8,157
"1047156358343282688",26,312,297,65,700
"1047159010632355842",2,85,11,3,101
"1047175026259189761",14,122,65,22,223
"1047189115689754624",4,61,28,3,96
"1047234792532529152",12,99,173,18,302
"1047294700246454273",8,75,46,8,137
"1047296564388147200",13,136,79,16,244
"1047309022892707841",9,85,35,4,133
"1047309776374259712",11,123,56,11,201
"1047319923700060161",6,69,35,9,119
"1047465256023445504",6,83,14,3,106
"1047469711938736128",12,114,223,30,379
"1047472342354604033",13,144,64,13,234
"1047475390573371395",4,61,37,11,113
"1047477260624773121",6,52,17,3,78
"1047486972976095233",6,64,9,1,80
"1047487803746074624",7,83,36,4,130
"1047489875614883841",8,85,31,3,127
"1047493831426498561",16,174,265,32,487
"1047495435760427008",6,90,45,9,150
"1047637712004636673",13,130,31,4,178
"1047673458241560576",27,294,302,44,667
"1047822816580722690",18,249,182,48,497
"1047842341246173185",13,154,97,31,295
"1047847548600377344",15,214,183,42,454
"1047853098365079553",16,204,175,31,426
"1047903710389534720",11,141,111,30,293
"1047928708172894208",8,77,21,2,108
"1047931723302887424",6,83,29,2,120
"1047974091318149120",8,116,36,5,165
"1048012979357270017",13,127,37,9,186
"1048015772214353921",8,106,45,6,165
"1048196883464818688",52,371,685,92,1200
"1048197648807854080",27,256,108,32,423
"1048226225196552193",27,297,195,42,561
"1048606042123395072",18,237,159,39,453
"1048665701513187328",13,203,50,14,280
"1048668088059584512",48,484,262,82,876
"1048693669870501889",30,267,294,68,659
"1048737154778759168",8,122,30,14,174
"1048743461543763969",5,134,45,14,198
"1048745061888880640",42,497,587,87,1213
"1048946652621541377",15,130,61,8,214
"1049292375330361345",11,138,154,21,324
"1049321480780099584",4,67,19,12,102
"1049367031433383936",6,66,10,5,87
"1049373138130280449",14,101,16,3,134
"1049380830395609090",10,109,10,1,130
"1049383326975373312",16,123,30,8,177
"1049385141557030912",6,80,20,4,110
"1049445228694962176",9,100,64,10,183
"1049473255151755264",6,120,46,16,188
"1049638803177127936",21,176,386,51,634
"1049640099007356928",9,110,110,22,251
"1049648174896504832",9,78,48,9,144
"1049665483182694402",17,83,62,30,192
"1049690971934511104",7,57,18,7,89
"1049690974841135104",3,45,20,0,68
"1049692727582048258",13,81,14,2,110
"1049700215949860864",11,114,56,8,189
"1049738503389675521",7,54,15,3,79
"1049776359239643136",8,116,69,10,203
"1049829285677203456",17,143,50,15,225
"1049831428115062790",6,50,17,1,74
"1049832845592723457",11,110,29,5,155
"1050004777034309633",9,113,34,6,162
"1050008315286171648",21,183,235,57,496
"1050054830843199490",13,87,43,6,149
"1050111823842893824",15,89,124,18,246
"1050129323724816388",9,88,71,13,181
"1050187347860627456",10,85,29,8,132
"1050189312904581120",21,192,156,18,387
"1050197632524660736",5,78,7,2,92
"1050198107969982464",4,73,13,2,92
"1050230507689189381",17,150,30,8,205
"1050395852466995202",6,58,17,2,83
"1050396488839430144",5,62,47,6,120
"1050421238429077505",5,53,45,9,112
"1050743405578457093",9,79,36,8,132
"1050746600916754432",8,90,223,40,361
"1050747691062493185",13,94,25,4,136
"1050754462405537798",22,210,33,40,305
"1050777580553588738",10,122,29,8,169
"1050788995377049601",12,129,41,11,193
"1050810652271529984",14,131,97,7,249
"1050826148131860480",11,89,73,14,187
"1050832839678353410",6,52,22,1,81
"1050869299567562752",10,70,16,7,103
"1050872423317471232",23,162,40,10,235
"1050906531162677248",13,78,39,6,136
"1051103122163204097",10,99,12,0,121
"1051111923788513281",13,107,23,6,149
"1051114825391239169",19,156,74,11,260
"1051156386179141632",10,103,22,9,144
"1051166436029358081",19,212,73,13,317
"1051168800324931584",18,125,54,14,211
"1051211563946975233",5,73,8,4,90
"1051213021115285504",10,154,16,12,192
"1051217592554323973",6,73,53,10,142
"1051280606536105984",11,85,24,5,125
"1051317348496490496",11,118,33,12,174
"1051319975795933184",12,153,64,10,239
"1051471737068670977",26,235,141,30,432
"1051473226109513728",9,78,48,4,139
"1051558072433463297",15,71,117,27,230
"1051559539605164034",8,98,64,17,187
"1051561865061502977",19,141,36,13,209
"1051801524857384960",15,191,81,11,298
"1051807774894624768",14,184,166,21,385
"1051811228362919938",7,70,44,6,127
"1051814214212485120",15,105,200,31,351
"1051832118165139458",4,49,53,13,119
"1051861686842474496",7,82,62,7,158
"1051984061860904960",15,140,114,13,282
"1051992718807830529",12,130,50,8,200
"1052168909665824769",20,167,162,43,392
"1052171444082360320",11,153,80,21,265
"1052173526919196672",17,215,93,22,347
"1052181272137801728",4,85,29,3,121
"1052183647552491521",23,274,74,56,427
"1052184484941049857",6,94,72,9,181
"1052186219696803841",14,121,253,26,414
"1052200515608690688",14,153,73,16,256
"1052213711295930368",26,165,470,88,749
"1052217314463100928",5,87,26,6,124
"1052219253384994816",18,153,106,21,298
"1052233253040640001",12,88,33,4,137
"1052268011900555265",9,62,141,28,240
"1052268013876064256",8,48,65,4,125
"1052270676982333442",14,180,39,9,242
"1052344365442588673",4,60,50,12,126
"1052368431201341447",30,247,73,44,394
"1052369731959820292",32,265,101,45,443
"1052387851088867330",13,142,134,23,312
"1052388580734263297",9,85,53,10,157
"1052522197347119104",15,155,150,25,345
"1052527724143763456",9,141,83,15,248
"1052529703800721408",13,129,99,22,263
"1052532141941301248",5,91,30,5,131
"1052537536961306625",17,105,37,8,167
"1052539788190986240",7,100,62,13,182
"1052556222459727872",14,166,67,31,278
"1052556944068755456",8,116,43,14,181
"1052609907344715777",5,65,15,2,87
"1052612579099521024",2,58,14,5,79
"1052614789828993024",2,79,15,3,99
"1052615582560923648",3,61,12,1,77
"1052618395722559488",2,62,22,3,89
"1052641581650640903",18,147,378,48,591
"1052644447853453312",4,81,26,6,117
"1052681628240281600",6,81,19,5,111
"1052741954918866944",12,180,80,6,278
"1052883467430694912",15,141,111,21,288
"1052885781675687936",27,262,95,90,474
"1052888451199262725",17,160,95,22,294
"1052914382986973184",5,98,31,1,135
"1052947507238658049",4,51,14,5,74
"1052947510271111170",2,41,44,5,92
"1052950726907969536",9,58,29,6,102
"1052964059056885760",6,60,33,3,102
"1053008701026693122",23,213,279,49,564
"1053013864244219904",18,169,139,39,365
"1053033702253424640",10,101,30,7,148
"1053070661302669312",8,89,21,2,120
"1053074465150578688",13,100,37,5,155
"1053076069564071936",8,121,88,7,224
"1053102147888328704",9,73,27,1,110
"1053121500151074817",14,151,75,15,255
"1053124336637247493",20,189,144,21,374
"1053285341610668034",6,92,18,4,120
"1053285828892463109",17,126,250,16,409
"1053336553391452161",15,132,114,17,278
"1053338516501889025",22,169,185,20,396
"1053355470449127424",13,137,114,15,279
"1053432380860456960",16,167,84,16,283
"1053448472156749824",11,121,42,11,185
"1053456620334678016",8,71,24,6,109
"1053484232138358785",23,200,58,17,298
"1053485357734408192",8,88,40,12,148
"1053655992649506821",28,228,171,51,478
"1053657849606234112",6,119,79,4,208
"1053658596712431616",8,88,37,4,137
"1053661248217202688",11,167,83,10,271
"1053662989272793089",16,161,100,10,287
"1053682023066288128",11,122,35,7,175
"1053684769991454721",9,106,46,10,171
"1053740855016574976",5,80,38,7,130
"1053807130120200192",31,337,482,71,921
"1053839625679183872",14,144,49,8,215
"1054087893034172418",22,203,90,55,370
"1054088531629490178",10,168,195,41,414
"1054091502585069568",16,179,171,15,381
"1054187956024590336",19,204,165,25,413
"1054348185160896513",10,85,19,4,118
"1054351078328885248",28,262,316,103,709
"1054354059535269888",29,270,169,60,528
"1054356145798856704",25,243,132,76,476
"1054356359096033281",7,90,54,16,167
"1054430376557535232",27,184,57,21,289
"1054432329710608385",12,119,68,22,221
"1054451954397667328",11,86,29,9,135
"1054451956608049152",12,83,47,2,144
"1054454173142380544",12,88,35,13,148
"1054460902076862466",7,70,10,6,93
"1054461380797943809",10,88,24,8,130
"1054486312701517824",10,127,60,9,206
"1054543818249388034",5,93,22,5,125
"1054545561234427905",10,110,25,10,155
"1054556416155910144",12,138,70,9,229
"1054560552117133313",11,121,84,17,233
"1054564283634266112",12,112,12,1,137
"1054588738641178624",8,112,28,3,151
"1054732552488083459",12,110,35,6,163
"1054755401651179521",18,159,111,22,310
"1054759617165754372",8,97,30,6,141
"1054770300359991297",6,67,25,2,100
"1054771761500377090",8,78,50,6,142
"1054775397798178816",20,148,167,36,371
"1054874705491120133",80,572,107,43,802
"1055064484644089856",23,210,94,32,359
"1055065538890735616",23,223,95,25,366
"1055075245743374336",12,107,76,5,200
"1055077740792160256",13,186,530,41,770
"1055127893112696832",30,148,339,50,567
"1055170989682757632",22,152,210,20,404
"1055246191443763201",13,100,55,10,178
"1055273659563171840",13,110,57,8,188
"1055412328571850753",15,155,160,26,356
"1055414972635926528",18,146,146,25,335
"1055418269270716418",42,312,828,120,1302
"1055458320390217728",20,190,168,28,406
"1055494636775657478",8,66,21,3,98
"1055527191235227648",35,335,178,61,609
"1055529948046331904",7,70,35,2,114
"1055531230022766592",8,92,17,2,119
"1055531231495024642",6,63,15,5,89
"1055548456469778432",7,80,20,4,111
"1055548549595873280",5,88,17,1,111
"1055555312864952321",8,77,19,2,106
"1055555764901822466",8,85,23,5,121
"1055559438977900544",10,114,62,6,192
"1055599805395812352",11,77,7,3,98
"1055600267331285002",11,92,24,1,128
"1055719340832686080",31,239,455,71,796
"1055820292881350656",23,180,85,31,319
"1055822810940129283",32,258,366,101,757
"1055826295337172993",29,232,462,71,794
"1055846847502258178",11,113,94,16,234
"1055872564386398209",12,80,82,10,184
"1055881545628704769",12,126,89,7,234
"1055887335378874368",9,93,24,4,130
"1055893947531382784",13,151,98,20,282
"1055932751516332033",18,145,43,10,216
"1055938940337672192",21,199,131,27,378
"1055987125701742592",7,87,49,7,150
"1056175920476766208",10,77,30,11,128
"1056178393522339847",18,155,65,9,247
"1056179047368134656",7,80,9,0,96
"1056180185727418374",9,87,13,9,118
"1056181643810168832",11,117,82,9,219
"1056182288927649794",7,54,12,0,73
"1056184390684995584",28,207,105,20,360
"1056200966809288704",31,138,163,21,353
"1056220576098992129",23,145,179,24,371
"1056270246141681664",9,107,60,18,194
"1056299896406450176",25,196,76,8,305
"1056299897882923009",23,159,194,19,395
"1056391795523895296",70,238,299,80,687
"1056394547637485574",23,204,187,20,434
"1056589723911757824",14,117,66,11,208
"1056592374607024130",21,127,345,38,531
"1056700376718684160",34,327,607,106,1074
"1056879122348195841",28,241,498,69,836
"1056880287974649856",15,150,140,28,333
"1056885392522260480",19,204,117,19,359
"1056919064906469376",30,267,358,52,707
"1056922209111994373",23,251,339,51,664
"1056923033141698561",6,83,35,1,125
"1057059603605831680",25,222,247,32,526
"1057063101189836801",16,165,182,36,399
"1057067460925505536",5,79,117,10,211
"1057069393090355200",25,324,82,11,442
"1057092628951502849",7,97,22,2,128
"1057106123260678144",6,73,11,2,92
"1057106631652196354",8,111,26,2,147
"1057108130662899713",6,74,17,2,99
"1057109765178966017",8,95,20,1,124
"1057110242541080577",5,80,33,2,120
"1057243826899877889",12,101,20,8,141
"1057247021919297536",9,89,23,2,123
"1057249169507803137",18,188,212,33,451
"1057254051254013953",9,99,41,9,158
"1057288679390097408",17,152,101,11,281
"1057325714721124355",8,86,16,1,111
"1057325717162213378",9,69,55,4,137
"1057325873312026624",13,96,71,3,183
"1057612657665171457",10,119,197,30,356
"1057614564639019009",25,208,200,42,475
"1057619304949133312",13,88,58,7,166
"1057620518751428608",15,120,354,40,529
"1057624553478897665",25,192,286,55,558
"1057637708296794114",12,139,78,13,242
"1057638285026254848",14,104,254,42,414
"1057654684356395008",8,113,83,3,207
"1057655675080314880",12,153,350,32,547
"1057674390446448642",27,231,282,73,613
"1057683481793302528",19,160,65,20,264
"1057714919766925314",10,108,133,12,263
"1057715198684000258",18,201,113,22,354
"1057728445386539008",21,270,488,51,830
"1057797701834813440",17,132,37,9,195
"1057810265436090368",10,101,40,11,162
"1057837892062666755",16,137,100,19,272
"1057997981922873344",15,136,58,16,225
"1058064549977473025",1,60,6,0,67
"1058065450075086850",6,83,26,2,117
"1058100070158098433",28,164,171,28,391
"1058119417278676992",3,53,27,9,92
"1058182740414226433",9,138,48,12,207
"1058187885042716672",11,102,51,9,173
"1058354748578033664",17,199,88,15,319
"1058356796262412288",13,128,102,14,257
"1058388700617498625",49,238,255,51,593
"1058477374872920064",5,83,44,6,138
"1058482506037641216",5,97,34,7,143
"1058498592208494592",8,110,30,0,148
"1058519264771096576",4,84,27,5,120
"1058521517821190146",2,110,37,4,153
"1058531139034451969",7,80,42,2,131
"1058553398172237824",4,100,25,7,136
"1058673875372908544",17,179,171,35,402
"1058687674742120448",5,90,27,1,123
"1058691406263451648",6,90,41,12,149
"1058711461214724097",6,63,24,0,93
"1058715144442781696",34,310,118,41,503
"1058758825300365312",8,76,31,3,118
"1058762842629984256",6,97,44,7,154
"1058781668151050240",13,108,381,47,549
"1058820790546821120",6,135,102,10,253
"1058825551090237441",6,119,47,7,179
"1058827516427808768",31,169,245,37,482
"1058829182275411979",15,137,42,6,200
"1058829196062048257",7,100,28,4,139
"1058893955084025856",8,103,40,8,159
"1058896605527597056",7,96,27,2,132
"1058898124448677890",13,112,95,14,234
"1058913612813791232",15,146,55,15,231
"1059101889898430464",19,183,287,49,538
"1059152270342975489",7,112,46,11,176
"1059174162965716992",6,77,30,18,131
"1059220177169063941",4,76,41,4,125
"1059230569257680896",6,81,15,2,104
"1059258034474704897",11,164,29,20,224
"1059264061030969344",8,104,27,7,146
"1059310562771984390",14,148,40,15,217
"1059317426653933568",6,110,91,10,217
"1059433483423178752",10,111,44,14,179
"1059435440497934337",13,151,79,17,260
"1059439426022137856",10,129,48,10,197
"1059460759179198470",8,109,39,10,166
"1059464880955277312",21,218,121,35,395
"1059469158830796800",12,175,85,10,282
"1059470847751131138",30,244,397,44,715
"1059505422430801920",8,119,71,11,209
"1059550850673229826",18,131,44,10,203
"1059557569818181632",4,86,23,3,116
"1059561007520116741",10,81,59,7,157
"1059573108464648198",5,59,32,6,102
"1059611961539915776",6,63,12,3,84
"1059612735271505920",10,87,46,2,145
"1059618041716228096",9,103,24,12,148
"1059623256087506944",10,73,21,6,110
"1059630186738737152",11,127,95,22,255
"1059674931737300993",9,97,52,3,161
"1059695972907921408",6,91,21,7,125
"1059827782434328582",19,209,122,20,370
"1059833982777544705",6,68,23,4,101
"1059867563746824192",5,70,16,6,97
"1059870147845017601",8,118,32,10,168
"1059880322500833281",6,78,15,4,103
"1059896399595225089",8,109,25,11,153
"1059897349005283334",12,82,29,7,130
"1060022696703070208",41,309,433,79,862
"1060056007316045825",13,163,97,23,296
"1060058718937800704",13,132,66,14,225
"1060061704850206720",8,89,50,3,150
"1060130202418864129",15,155,125,16,311
"1060138691778301953",7,121,26,4,158
"1060141780878979072",16,179,129,18,342
"1060148982968733696",11,96,118,15,240
"1060153052676702208",19,187,301,44,551
"1060155917059219461",40,304,554,81,979
"1060162807960870913",12,109,94,40,255
"1060194964351660033",18,188,320,49,575
"1060256619383193601",39,223,216,48,526
"1060256623439110146",21,150,167,40,378
"1060511925883285504",24,126,89,21,260
"1060515116700045312",23,185,104,21,333
"1060723241193484288",31,312,324,82,749
"1060908430062481408",14,115,49,11,189
"1060923822851874816",15,135,122,19,291
"1060924708101644288",25,283,203,53,564
"1060938144336367616",31,317,187,57,592
"1060942600994050048",11,142,154,19,326
"1060949297900834816",22,242,167,63,494
"1060958713047961600",25,281,467,91,864
"1060960329876697088",15,172,102,21,310
"1060964991510110208",22,227,143,25,417
"1060993836984324096",41,382,432,91,946
"1061003186125856769",20,191,217,65,493
"1061104224090628097",12,123,209,22,366
"1061107399426220037",6,103,113,20,242
"1061168803218948096",41,179,1395,211,1826
"1061171030801158146",21,167,352,63,603
"1061259607086112769",19,169,94,13,295
"1061334384337399808",10,118,212,28,368
"1061335051294728194",20,194,377,63,654
"1061382890100002817",28,180,288,32,528
"1061383163811893248",19,141,117,15,292
"1061554334276747264",11,163,415,63,652
"1061623758161625089",13,141,100,18,272
"1061632874808520709",15,114,127,23,279
"1061650654194745344",13,130,36,17,196
"1061840511026298880",12,133,80,11,236
"1061952604807274498",18,153,186,25,382
"1061954325843468288",11,106,54,11,182
"1061957074253418496",11,122,97,14,244
"1061962869376540672",23,249,526,73,871
"1062005636488142848",17,126,435,59,637
"1062020057616793600",18,170,142,15,345
"1062045654711713792",13,124,85,11,233
"1062047641889095684",12,103,76,14,205
"1062153051459469312",38,199,269,55,561
"1062311785787744256",22,139,197,39,397
"1062331024426913792",16,176,133,33,358
"1062333534214520832",15,127,161,23,326
"1062333882610171907",17,135,163,31,346
"1062371844836261891",26,186,364,48,624
"1062382618870726656",15,170,171,35,391
"1062391577807601664",17,212,241,47,517
"1062429580521168896",9,105,73,7,194
"1062450942707228672",5,62,63,8,138
"1062455263247155200",9,64,30,4,107
"1062459010660622339",14,156,112,19,301
"1062789364399390720",11,146,69,23,249
"1062791114716000258",12,87,40,5,144
"1062796884648120320",19,121,168,34,342
"1062830145768165377",9,125,48,14,196
"1062849316161753093",14,118,50,11,193
"1063038733673525248",15,159,270,53,497
"1063042585802039296",26,194,400,62,682
"1063046973857718272",23,189,452,70,734
"1063081553075625984",18,188,406,62,674
"1063084073231544320",21,204,436,57,718
"1063161848952836096",12,111,53,9,185
"1063168341941063680",6,90,38,10,144
"1063169733535678464",10,129,69,13,221
"1063170699500642304",14,109,193,25,341
"1063516048647995394",8,73,23,4,108
"1063517548258447361",18,179,243,39,479
"1063549250250960897",10,71,37,7,125
"1063591735169871872",10,177,30,6,223
"1063591994738515968",12,136,78,16,242
"1063593456579354624",21,206,71,32,330
"1063593459695669254",16,187,125,25,353
"1063631319739953152",16,79,46,10,151
"1063758107229257728",11,85,114,30,240
"1063833980720504832",14,72,89,37,212
"1063834729584054272",10,100,67,11,188
"1063834733430206465",13,128,136,8,285
"1063835936604090368",9,81,80,6,176
"1063987157650485249",21,184,136,29,370
"1064209246114459648",9,61,151,26,247
"1064216956679716864",34,218,716,101,1069
"1064227483187318784",19,187,96,25,327
"1064245710747590657",25,262,160,43,490
"1064246787161145346",13,140,72,13,238
"1064526362994778113",6,59,73,10,148
"1064540462848098304",24,183,285,37,529
"1064544156960387072",20,214,90,38,362
"1064596708875747328",34,348,214,68,664
"1064734907941994497",15,105,98,7,225
"1065088330969305089",11,159,385,79,634
"1065102519188275201",26,221,257,45,549
"1065225779825598465",21,137,368,72,598
"1065225940836458496",27,237,291,61,616
"1065247567443869696",7,58,59,8,132
"1065261943202738178",9,83,143,21,256
"1065346909362143232",20,175,253,45,493
"1065351478347530241",16,152,122,30,320
"1065357030985252865",12,125,51,9,197
"1065359825654169600",13,159,179,42,393
"1065368645021388800",12,157,83,27,279
"1065400254151954432",30,167,926,140,1263
"1065403512559992832",29,241,373,106,749
"1065575219576926208",7,87,118,20,232
"1065576088779272192",18,196,153,89,456
"1065581119242940416",22,180,222,36,460
"1065583286188158976",13,147,127,24,311
"1065601413189984256",15,128,164,23,330
"1065623990746710022",12,137,94,23,266
"1065718109624066049",17,105,174,43,339
"1065743662464802817",17,183,191,48,439
"1065948536498544640",29,280,254,59,622
"1066017112425185280",15,116,60,10,201
"1066116263649382400",16,143,160,21,340
"1066478927143677952",23,264,109,52,448
"1066480700046655488",18,253,102,46,419
"1066665948193669120",11,114,75,10,210
"1066670550708301824",9,141,169,25,344
"1066682146683846657",7,102,77,10,196
"1066685057648214018",21,225,207,48,501
"1066689688600281088",15,173,320,54,562
"1066786854643662848",9,105,109,20,243
"1066788767133040640",11,162,78,20,271
"1066790517944606721",11,129,90,21,251
"1066793504804913152",17,233,220,49,519
"1066873981293260801",23,201,194,29,447
"1066876053170339840",22,199,247,37,505
"1067015026995879937",38,286,286,76,686
"1067063727994884096",27,180,197,33,437
"1067066584882126848",18,157,218,37,430
"1067142262545674240",14,107,55,8,184
"1067142819008122885",17,133,90,17,257
"1067142820388052993",16,124,257,44,441
"1067151248040824833",10,81,23,1,115
"1067151249668214793",7,71,54,6,138
"1067395266511347713",17,170,239,32,458
"1067398375337791488",17,169,219,27,432
"1067404517841518593",23,206,297,40,566
"1067410952042283010",8,106,104,13,231
"1067494680416407552",27,172,158,47,404
"1067494682249318402",23,140,109,26,298
"1067576713859817472",21,233,314,49,617
"1067623816921272325",14,128,107,32,281
"1067624656943935493",13,156,123,19,311
"1067775022331236352",18,193,261,38,510
"1067791101782831104",6,121,51,11,189
"1067792610180456448",12,121,81,15,229
"1067812811068383232",23,175,137,25,360
"1067924142316494848",27,218,144,55,444
"1068000629409398784",10,124,126,13,273
"1068001369746022400",15,125,237,33,410
"1068106609644183554",15,119,80,16,230
"1068110895409233921",17,176,262,45,500
"1068116413498429445",15,165,351,68,599
"1068120444279103488",12,141,178,26,357
"1068181367857397760",21,115,131,18,285
"1068181371883909121",7,79,115,13,214
"1068264306947411968",7,91,46,4,148
"1068266944715878402",4,73,44,4,125
"1068266949115695104",5,50,35,3,93
"1068271965343862785",12,110,91,13,226
"1068274204208812033",7,98,107,18,230
"1068275406141149184",5,75,32,11,123
"1068294634160287744",10,111,143,14,278
"1068319160093032448",6,53,70,12,141
"1068336562729938945",11,123,223,25,382
"1068339979250675712",21,195,234,36,486
"1068346689784696833",4,91,147,20,262
"1068442531887632384",21,197,438,78,734
"1068444287380025344",18,128,349,35,530
"1068491952696557575",3,71,30,5,109
"1068516326010830849",18,192,143,27,380
"1068600355225690112",14,128,66,14,222
"1068601345949687808",7,70,104,5,186
"1068661832578158592",7,61,44,8,120
"1068687025505595392",5,48,136,10,199
"1068743940755660800",19,95,73,10,197
"1068826073775964160",2,5,2,1,10
"827715246135574530",16,112,94,47,269
"827864176043376640",37,182,205,66,490
"827865957750161408",21,108,165,29,323
"827867311054974976",31,145,627,96,899
"827874208021639168",10,53,212,30,305
"827885966509604865",41,362,404,69,876
"827981079042805761",26,142,539,130,837
"827996357252243456",17,113,379,85,594
"828024835670413312",4,67,153,37,261
"828039143318024194",6,48,94,21,169
"828042506851934209",14,92,318,70,494
"828342202174668800",27,110,365,92,594
"828343072840900610",16,111,235,63,425
"828375073006444544",23,224,132,43,422
"828447350200926212",92,547,102,57,798
"828574430800539648",39,126,615,76,856
"828575949268606977",23,87,548,60,718
"828642511698669569",18,59,312,42,431
"828748574255091714",2,22,74,14,112
"829133645055135750",19,208,704,143,1074
"829299566344359936",9,112,223,54,398
"829315036329963521",2,41,99,22,164
"829349943613734912",11,72,15,17,115
"829356871848951809",34,107,928,164,1233
"829357626798530561",4,72,93,18,187
"829384587482656768",17,56,220,52,345
"829410107406614534",11,130,42,13,196
"829414457126313986",15,138,228,50,431
"829446266111287305",8,101,81,16,206
"829451566000242688",8,70,334,39,451
"829496507841789952",20,187,185,54,446
"829660612452036608",13,75,210,39,337
"829681034564341760",4,51,148,41,244
"829682794951475200",12,44,143,53,252
"829721019720015872",4,43,107,18,172
"829836231802515457",99,333,1419,238,2089
"830042498806460417",5,77,137,35,254
"830047626414477312",13,88,184,40,325
"830195857530183684",9,83,88,26,206
"830389130311921667",13,91,175,59,338
"830407172747988992",8,39,104,20,171
"830409522397184000",6,62,95,35,198
"830483672096768001",5,45,63,17,130
"830552079240409089",18,141,254,81,494
"830555911559249926",8,37,53,12,110
"830558065715998726",4,49,94,21,168
"830643095150657536",10,32,51,3,96
"830741932099960834",14,132,140,53,339
"830747067379232769",15,99,127,46,287
"830751875578355713",15,91,106,27,239
"830764596235485188",4,37,37,10,88
"830769247185952772",13,46,265,50,374
"830804130692268032",10,59,199,37,305
"830904083519242241",12,101,585,91,789
"831169341358014475",8,53,58,11,130
"831185943482793986",9,41,40,13,103
"831214091993751552",6,67,74,23,170
"831336432073658368",2,38,43,10,93
"831344902990655489",8,83,40,30,161
"831510532318429184",27,91,791,148,1057
"831599387906301952",6,52,59,16,133
"831621079747723264",6,35,25,6,72
"831636777110757377",6,86,235,53,380
"831830548565852160",20,94,296,61,471
"831837514226921472",23,102,447,69,641
"831840306161123328",14,67,236,45,362
"831842652085686273",8,46,136,26,216
"831846101179314177",11,80,180,45,316
"831853862281699331",40,126,496,89,751
"831904516316479489",6,36,41,7,90
"831945670324060164",7,64,19,12,102
"831952535544070145",9,79,169,37,294
"831979921555742732",5,71,76,17,169
"832016501657968640",35,73,74,16,198
"832191485701451777",14,134,115,44,307
"832197515248275456",14,68,167,41,290
"832230758299340800",11,70,223,35,339
"832238070460186625",17,92,466,82,657
"832375230274400256",17,94,145,34,290
"832533430168608768",8,76,63,26,173
"832554772318322688",4,54,40,25,123
"832555987299082242",22,126,333,84,565
"832579442790772736",9,36,51,20,116
"832614137586933760",6,30,66,13,115
"832708293516632065",64,227,829,140,1260
"832730328108134402",9,81,352,65,507
"832742165436579840",4,52,228,57,341
"832945737625387008",25,190,469,95,779
"832950628750127106",9,51,230,39,329
"833681539997253636",17,119,363,52,551
"833686030679207936",43,321,290,97,751
"833783438922629125",9,46,50,21,126
"833838311315763200",8,67,38,20,133
"834142323881684993",13,121,158,36,328
"834181712783560705",20,109,701,80,910
"834377364947816448",15,32,125,23,195
"834384982495940613",14,61,87,25,187
"834899071982841856",5,36,35,3,79
"834916167177371648",9,101,187,41,338
"834917440450609152",6,26,37,12,81
"835104946034991106",16,68,113,26,223
"835124485632180224",4,31,100,36,171
"835173525522624512",13,105,44,28,190
"835325771858251776",23,92,440,68,623
"835465719970217984",24,147,324,79,574
"835479283699224576",61,436,423,64,984
"835481237879926784",8,93,82,17,200
"835553050530099200",4,49,34,9,96
"835608648625836032",60,86,609,96,851
"835610917568200705",25,135,167,33,360
"835814988686233601",12,50,194,35,291
"835817351178301440",13,71,288,43,415
"835916511944523777",19,101,445,70,635
"835946001873657858",7,67,111,38,223
"836261209540288513",9,66,151,33,259
"836332166728527872",5,57,167,24,253
"836406328369242113",5,30,160,41,236
"836933725602656256",14,130,117,159,420
"837256338203881472",32,209,194,53,488
"837488402438176769",7,85,144,38,274
"837633820417482754",2,57,80,10,149
"837638488656920576",19,135,331,72,557
"837704599704375296",8,34,43,7,92
"837722869106880517",51,392,352,85,880
"837766616603586560",10,71,88,15,184
"837770149767827456",28,248,258,75,609
"837787963027144706",25,210,105,29,369
"837987684660412416",13,135,52,15,215
"837989835818287106",44,318,381,115,858
"837991759045079040",30,235,168,37,470
"837993273679560704",34,222,207,60,523
"837994257566863360",23,186,313,96,618
"837996746236182529",45,296,899,196,1436
"838016045222854656",23,73,436,87,619
"838351476401520640",11,101,179,31,322
"838353481526312961",19,197,217,71,504
"838441522546769923",16,165,300,82,563
"839268048313929729",5,70,158,55,288
"839433678275153921",17,124,400,45,586
"839433951957696513",15,123,192,29,359
"839448469374894080",8,72,132,19,231
"839624377826230272",1,37,22,13,73
"839625347524096000",10,115,91,17,233
"839883804315684864",39,78,331,79,527
"839968149890076672",5,70,118,21,214
"839976956703748096",3,33,31,5,72
"840225958854561792",4,25,48,9,86
"840572799202783233",11,66,292,73,442
"841270741060464648",12,62,279,46,399
"841275470796738560",4,43,158,25,230
"841338126316511233",2,26,50,12,90
"841392683625172992",3,74,153,37,267
"841665325682827265",12,143,151,33,339
"841683431398469632",5,57,99,17,178
"841966077005463553",14,100,274,54,442
"841967881516679168",43,171,252,59,525
"841970726341074945",8,53,67,17,145
"841974528683192320",6,46,79,22,153
"841985915778142209",5,68,111,19,203
"842117164144431104",6,35,84,13,138
"842164356297175040",4,67,98,24,193
"842229104434913280",5,58,74,16,153
"842403173742579714",7,71,201,26,305
"842467917639913472",6,47,18,7,78
"842494190990901248",6,48,133,35,222
"842710123852320770",5,59,41,17,122
"842724011234791424",11,63,175,49,298
"842739155230740481",5,49,54,8,116
"842762240184999936",3,30,41,18,92
"843088518339612673",9,83,274,39,405
"843090516283723776",12,64,199,34,309
"843557782666317826",5,23,37,3,68
"843772976151642112",7,48,172,32,259
"843776582825267201",10,80,228,27,345
"843779892776964097",21,42,230,40,333
"843803115044454402",13,60,284,62,419
"843813078076719107",11,76,391,50,528
"843873596963459072",7,66,57,21,151
"844010257454153729",11,82,120,21,234
"844232766711648256",3,26,41,17,87
"844240534562594817",12,80,31,5,128
"844250273740738562",11,90,68,14,183
"844536536930619393",8,53,195,72,328
"844723847094026242",15,76,56,27,174
"844886082663698436",17,82,310,59,468
"844930836663357440",17,138,52,14,221
"844943801848414209",6,47,187,22,262
"845037368386207746",11,76,52,23,162
"845247455868391425",9,61,358,87,515
"845249587178819584",5,55,184,79,323
"845320243614547968",4,62,178,23,267
"845334323045765121",9,108,135,19,271
"845628655493677056",4,83,25,10,122
"845645916732358656",19,108,420,109,656
"845646761704243200",3,39,125,29,196
"845974102619906048",23,58,259,97,437
"846166053663191040",12,94,172,30,308
"846533818811080704",22,127,282,57,488
"846537639167713281",9,31,80,31,151
"846543183223963649",13,56,268,67,404
"846672219073863681",10,123,133,26,292
"846682464215076866",1,22,87,13,123
"846745288735887360",6,48,150,20,224
"846828561491202048",5,19,27,2,53
"846841493952319489",2,35,102,17,156
"847056211006631936",9,54,142,17,222
"847061031293779969",23,86,362,93,564
"847201455165624320",1,24,22,9,56
"847236476815511552",2,44,77,10,133
"847270189171228672",10,96,43,17,166
"847435163143454723",15,60,154,152,381
"847455180912181249",7,47,173,37,264
"847558426557337600",0,23,20,5,48
"847559239149158401",7,30,54,29,120
"847559519085379584",1,18,19,14,52
"847573220417044480",7,38,60,11,116
"847625389908217856",12,70,105,20,207
"847766558520856578",27,82,316,39,464
"847819720418111488",2,26,23,3,54
"847863243200753666",2,43,47,20,112
"847867380562894848",2,64,42,4,112
"847878820220858369",2,67,74,11,154
"847895524632129536",4,32,23,6,65
"847924397180583937",5,66,74,17,162
"848153860602507264",20,79,303,65,467
"848158641056362496",15,85,223,47,370
"848203201094483972",5,41,48,8,102
"848216035153121285",8,61,87,19,175
"848299191646515202",7,62,44,9,122
"848519587675201538",11,68,146,27,252
"848521325480202240",4,61,84,59,208
"848529014667055105",11,89,242,56,398
"848701201315188736",23,169,64,30,286
"848841326183534594",9,80,97,30,216
"848856822312292354",11,81,98,23,213
"848857910297980928",10,119,520,85,734
"848880519458717698",9,86,186,41,322
"848928217138384896",5,43,54,17,119
"848957498040217603",3,43,28,4,78
"848983209580822529",7,39,41,10,97
"849330281412792320",2,24,13,4,43
"849345573509574665",4,38,27,5,74
"849366930133839872",2,21,43,11,77
"849732911377117185",11,49,47,19,126
"849807049118625792",12,136,124,25,297
"850053194923298816",2,59,35,5,101
"850722648883638272",1,29,19,7,56
"850722694958075905",0,22,12,7,41
"850723509370327040",18,135,74,34,261
"850785347038576640",8,43,127,15,193
"850800045012201473",11,114,69,25,219
"851092500056072198",10,49,26,11,96
"851092618754891781",6,33,15,11,65
"851247294854856706",8,67,12,10,97
"851555178910064640",11,97,42,22,172
"851584729400979456",14,92,37,15,158
"851766546825347076",9,72,38,8,127
"851767718248361986",34,134,112,28,308
"851781714028494849",2,63,50,13,128
"851894518014238720",4,35,36,5,80
"851997299454742528",1,26,63,9,99
"852134796436398086",6,68,38,11,123
"852138509355933697",3,70,86,17,176
"852277347587952640",3,34,24,6,67
"852318522139168769",21,168,184,48,421
"852508752142114816",23,116,69,12,220
"852510810287075329",26,107,171,35,339
"852602568433950720",5,55,22,3,85
"852985162870738944",1,32,33,6,72
"853583417916755968",9,40,105,12,166
"853584968047636480",19,231,60,86,396
"853595628655587334",10,45,479,80,614
"853597199619543041",14,90,478,70,652
"853604334944354305",12,84,154,22,272
"853771244579282944",4,46,80,13,143
"853942936337350656",5,68,118,23,214
"853944453538750464",7,76,91,15,189
"853945633903923200",11,58,215,36,320
"853964023846588420",6,70,156,27,259
"854157191053553666",5,61,72,6,144
"854268119774367745",10,77,87,16,190
"854270321620287490",2,16,57,13,88
"854283110191685634",10,58,106,6,180
"854284952539725828",4,73,105,10,192
"854433960566431746",8,76,109,18,211
"854438452661809152",3,28,69,11,111
"854547423464759296",9,63,169,31,272
"854676780527079425",13,71,123,26,233
"854749300114546688",8,76,59,25,168
"854793411110588418",6,56,27,10,99
"854870777287634944",5,51,64,7,127
"855055509455593472",15,87,170,34,306
"855142466034556928",8,52,70,12,142
"855172998747348998",2,25,29,5,61
"855368516920332289",8,58,58,14,138
"855373184861962240",10,48,267,60,385
"855406847200768000",3,44,47,3,97
"855517053238870019",13,105,18,22,158
"855582764418162690",8,42,37,7,94
"855626715707650048",6,47,36,8,97
"855814859069558784",1,48,36,15,100
"855816071663812608",7,58,150,23,238
"855817226078879748",8,94,77,25,204
"855859245023211520",15,67,285,21,388
"855901315305795584",13,82,276,22,393
"856146924705120256",8,29,41,9,87
"856147612952612864",0,14,17,2,33
"856150719656755200",9,45,123,28,205
"856171332521820165",12,73,146,25,256
"856172056932700164",18,49,263,28,358
"856233279841849344",8,41,171,38,258
"856234989591121922",5,43,193,33,274
"856481786938916865",4,21,77,14,116
"856484873133060101",4,44,88,9,145
"856508531087990785",0,0,9,4,13
"856531163799859201",3,27,75,13,118
"856556220911681539",5,29,21,3,58
"856557986474491904",8,69,173,20,270
"856606707463725057",4,62,52,12,130
"856830933709750272",2,32,31,4,69
"856847826663460865",17,46,112,16,191
"856849388026687492",17,136,176,102,431
"856928555179143168",3,41,24,1,69
"857014413081137154",3,45,36,6,90
"857177434210304001",10,83,117,35,245
"857180178736459776",6,40,30,13,89
"857182179469774848",10,53,74,27,164
"857185261029126144",7,27,45,13,92
"857246245672366081",23,135,66,44,268
"857295731929034753",3,20,48,14,85
"857335793261568000",4,41,38,11,94
"857360510534209536",12,42,19,7,80
"857552956836786177",10,80,34,17,141
"857555256003227648",5,43,18,5,71
"857557522584088576",12,89,84,39,224
"857604537003200512",7,39,89,21,156
"857604623531749376",6,56,78,17,157
"857604709829529601",4,71,89,14,178
"857604808676708353",2,45,68,9,124
"857605018266062848",8,48,101,27,184
"857605104417026049",14,60,255,38,367
"857670562478518273",4,28,22,3,57
"857711651952500737",2,13,5,3,23
"857931397562085376",7,82,75,21,185
"858148882756325379",10,60,178,33,281
"858343980823703553",6,49,100,24,179
"858375278686613504",13,93,235,48,389
"858645405252374528",2,16,47,6,71
"858653541094879232",6,60,95,27,188
"858654431956672512",14,129,253,52,448
"858659215451271168",8,46,96,26,176
"858660413873025024",15,53,157,46,271
"859127705366921216",4,27,37,9,77
"859143061678501892",2,25,51,16,94
"859209801175269376",15,42,378,53,488
"859392449181093888",2,28,48,39,117
"859393829505552385",38,82,271,104,495
"859514893418082310",5,35,11,3,54
"859601184285491201",17,86,152,40,295
"859604996236742656",13,71,276,49,409
"859874689442775045",2,33,25,3,63
"860081707315232771",6,54,31,27,118
"860083874893897728",4,23,31,6,64
"860087334519414784",15,74,171,36,296
"860088511202029569",2,17,45,8,72
"860108914624532480",4,33,41,5,83
"860153543151542272",1,37,55,10,103
"860188065758838785",7,68,97,30,202
"860191508619722752",5,61,131,33,230
"860194183797243904",3,24,149,20,196
"860326946147840001",6,65,172,28,271
"860377543878348800",1,22,21,2,46
"860477328882905089",3,51,98,14,166
"860479885566980096",7,58,315,53,433
"860573284462669824",8,52,194,36,290
"860577873060651008",6,76,65,9,156
"860580764944969728",4,42,46,15,107
"860638890570416132",7,64,112,24,207
"861177649179373569",12,83,122,33,250
"861201362834665472",10,55,131,35,231
"861300169438113793",19,45,96,19,179
"861544307043467264",8,60,17,1,86
"861550676505219073",12,53,287,20,372
"861592420043157504",16,68,199,27,310
"861637456281690113",4,17,36,6,63
"861993986436866049",12,51,40,10,113
"862059314277748736",1,37,65,10,113
"862135824745467905",31,193,333,70,627
"862263649821503489",7,96,120,24,247
"862265729718128641",10,86,168,37,301
"862267781336752128",13,70,252,43,378
"862282202188566529",10,53,76,22,161
"862283792559616000",6,61,87,19,173
"862286091759611905",5,51,150,20,226
"862290442129461249",5,55,145,24,229
"862387734492663808",16,165,292,52,525
"862460991451344896",31,272,276,66,645
"862752672683839488",5,29,16,3,53
"862753016193089536",6,43,72,12,133
"862758098892619780",36,286,100,22,444
"862767872879325185",25,119,329,51,524
"862788002594127873",8,39,144,11,202
"862998775731818496",24,82,145,29,280
"862999243560288256",15,68,161,32,276
"863000553265270786",18,46,275,42,381
"863002719400976384",22,80,319,74,495
"863007411132649473",72,72,568,68,780
"863014620516233216",11,71,306,59,447
"863020954427043840",29,203,165,35,432
"863139099825364994",4,57,39,13,113
"863140961114886144",3,42,30,8,83
"863194069891031041",7,46,75,27,155
"863452412459307009",5,31,80,18,134
"863468271668002817",7,79,64,31,181
"863774341921742848",20,155,108,59,342
"864207293289771012",2,49,87,19,157
"864296272844529664",12,125,43,51,231
"864436162567471104",35,70,315,65,485
"864438529472049152",23,75,195,32,325
"864452996129853444",29,76,468,69,642
"864511331029921792",5,63,68,16,152
"864565791076872192",9,39,151,36,235
"864942610191978496",3,56,163,45,267
"865173176854204416",44,186,817,170,1217
"865207118785372160",32,180,467,143,822
"865387523371143168",4,68,34,16,122
"865573793531478017",10,92,289,73,464
"865692565454106624",3,22,24,7,56
"865865814099939328",26,79,93,50,248
"865957909565366272",13,127,32,14,186
"866334629036384256",3,52,27,10,92
"866411249092902912",7,81,28,22,138
"866749195297976320",5,65,40,15,125
"866988278184116224",36,233,29,16,314
"867043258932875264",3,41,11,3,58
"867044286352809984",9,54,58,13,134
"867047119974170625",28,187,77,16,308
"867354520526872576",20,148,121,26,315
"867473100434161664",3,42,38,9,92
"867801005018230786",6,50,49,12,117
"867834190078906370",9,77,187,26,299
"868047480847568896",8,72,94,21,195
"868047612301148160",4,41,62,15,122
"868201805934678017",10,104,72,35,221
"868205058743250944",2,51,28,8,89
"868406076995235840",2,30,23,7,62
"868407229380268033",6,78,97,24,205
"868441116726710272",8,33,120,62,223
"868501243823575040",1,30,30,13,74
"868501423566315520",0,24,18,5,47
"868502563347451904",0,21,57,7,85
"868517059407335424",12,111,134,43,300
"868799536420065281",4,37,64,21,126
"868801710038372352",5,79,156,38,278
"868807327130025984",12,82,255,46,395
"868807754231820291",18,83,136,37,274
"868810404335673344",9,54,170,27,260
"868810522942164993",10,61,172,13,256
"868840252227674113",9,46,149,48,252
"868979531641741313",14,76,216,41,347
"868981969664843777",11,88,168,31,298
"868985285207629825",28,162,416,111,717
"869164414662049793",31,209,42,7,289
"869166145894535169",5,48,62,19,134
"869170351049240576",41,310,85,26,462
"869170615881793536",8,77,110,24,219
"869503804307275776",16,86,164,37,303
"869509894688387072",13,104,334,44,495
"869553853750013953",9,109,215,56,389
"869858333477523458",167,263,308,121,859
"869865463584620544",8,62,47,10,127
"869867413776601088",11,52,88,20,171
"869874798087819264",52,402,533,180,1167
"869902591005741056",3,55,91,24,173
"869903459511918592",8,40,266,67,381
"870008165827575808",6,65,108,17,196
"870035383458963456",4,24,26,9,63
"870077441401905152",29,155,449,81,714
"870083798981111808",25,80,306,87,498
"870234811616677889",19,129,311,57,516
"870355056327000065",1,36,187,41,265
"870445001125355522",27,320,460,93,900
"870709271477932032",5,85,161,23,274
"871087981225926656",8,61,40,10,119
"871325606901895168",44,427,271,87,829
"871328428963901440",20,217,344,93,674
"871331574649901056",35,326,509,86,956
"871674214356484096",22,101,132,30,285
"871675245043888128",9,70,109,20,208
"871677472202477568",5,72,75,17,169
"871679061847879682",10,97,154,41,302
"871722020278587393",12,112,337,48,509
"871725780535062528",19,98,525,54,696
"871830255396192256",2,47,18,9,76
"871840367070412800",7,58,78,14,157
"871899511525961728",27,170,263,54,514
"872043300949295104",7,74,80,13,174
"872059997429022722",30,132,349,72,583
"872062159789985792",12,83,68,14,177
"872064426568036353",20,103,357,67,547
"872084870620520448",10,62,61,7,140
"872086906804240384",11,57,100,16,184
"872147965451882496",23,188,59,16,286
"872243414930264065",5,35,70,15,125
"872253002266161153",6,33,44,32,115
"872258719404482561",24,147,79,14,264
"872419018799550464",40,144,145,28,357
"872427222392504320",11,73,231,46,361
"873120139222306817",35,205,760,124,1124
"873131235614347264",10,80,133,31,254
"873183401620230144",8,95,138,26,267
"873245481488535554",17,83,166,25,291
"873250570508922880",7,65,44,11,127
"873353586025132038",20,129,140,40,329
"873643935993708544",17,121,108,33,279
"873878061778907137",13,154,110,38,315
"873878232264822784",14,117,154,29,314
"873879934040780801",13,138,368,58,577
"873884774041079808",19,187,371,64,641
"874084433460154368",6,47,68,16,137
"874087477807599616",5,110,149,34,298
"874218586155479040",4,21,80,15,120
"874309930232184833",29,150,74,11,264
"874325287143604224",18,114,163,27,322
"874373283919089664",8,89,204,44,345
"874418514240688129",3,49,12,3,67
"874576057579565056",10,126,195,36,367
"874578159676665857",14,68,183,61,326
"874608587473080320",13,160,127,56,356
"874609480301936640",16,101,503,73,693
"874619861019840512",4,66,71,19,160
"874626492310978564",10,102,281,42,435
"874728484475744257",5,57,65,19,146
"874822136782880768",2,44,67,28,141
"874971795362897921",43,290,131,64,528
"874991696186142721",15,199,52,71,337
"875166406417010688",62,325,98,85,570
"875305788708974592",42,247,376,122,787
"875321478849363968",41,214,555,96,906
"875438639823675392",35,216,432,113,796
"875441788110110727",47,385,527,111,1070
"875468769212149760",2,35,27,5,69
"875500520840060928",15,112,38,14,179
"875682853585129472",16,121,246,68,451
"875690204564258816",24,157,404,55,640
"875698062030778368",16,131,176,40,363
"875701471999864833",58,238,495,130,921
"875732813278048256",18,112,225,36,391
"875840132238032897",5,44,31,4,84
"875888258407858176",10,135,147,42,334
"876079184417882116",19,111,46,14,190
"876388733607694336",18,122,189,36,365
"876390681056600066",11,116,93,23,243
"876394578777174021",17,162,514,88,781
"876558049565188096",17,100,76,26,219
"876778344636928000",12,132,206,35,385
"876896144944762880",7,61,79,11,158
"876899176562524160",4,67,28,5,104
"876899250071904256",2,30,20,7,59
"876900944444837890",4,98,42,17,161
"876901304207069185",1,56,67,9,133
"876921011668738050",6,30,24,9,69
"876948721468141573",13,107,31,19,170
"876964061027684352",22,114,146,17,299
"877101173412638720",8,105,84,10,207
"877104262463008771",12,140,103,18,273
"877204691851108353",4,78,26,8,116
"877234140483121152",12,71,88,30,201
"877341043171241984",5,38,9,8,60
"877350761742688256",7,56,29,14,106
"877353797760286720",9,101,54,18,182
"877355739383287808",12,157,42,28,239
"877363446530007040",3,80,9,8,100
"877372660455546880",20,235,129,48,432
"877474368661618688",15,185,277,54,531
"877674738364989440",5,38,42,11,96
"877846483021602816",2,61,68,14,145
"877878375045447680",8,94,53,17,172
"877879361130688512",16,132,176,44,368
"877889199353077760",13,104,75,20,212
"877891129194102785",16,137,125,25,303
"877892883352702976",16,164,188,76,444
"877932907137966080",13,58,80,31,182
"877932956458795008",18,38,315,44,415
"878006964072189952",3,51,18,17,89
"878013639613186049",23,236,212,66,537
"878019881353871360",3,48,199,42,292
"878027873650475008",3,67,64,16,150
"878078560715538432",2,59,28,5,94
"878192867847675904",3,22,82,14,121
"878200921980891136",18,154,305,80,557
"878341007103987712",5,100,25,16,146
"878365166538285057",7,76,64,11,158
"878413313188802560",26,175,443,91,735
"878596457741287424",13,111,227,42,393
"878711517537083392",13,108,246,39,406
"878715504063643648",12,108,159,37,316
"878717095701336064",13,115,220,74,422
"878725385235701761",25,293,277,57,652
"878946025662296064",24,111,419,54,608
"879315860178993152",9,127,124,28,288
"879317636164841474",6,137,115,36,294
"879320905608044544",4,76,114,26,220
"879323238425395200",8,100,143,22,273
"879324620159160322",8,92,306,39,445
"879326984794517507",5,81,230,46,362
"879405223399350272",21,224,138,54,437
"879525817361068032",12,90,127,20,249
"879527520957325314",14,143,95,25,277
"879648931172556802",19,169,136,26,350
"879678356450676736",19,187,179,39,424
"879682547235651584",26,165,306,59,556
"879827411008974852",4,73,208,38,323
"879828637733793793",6,104,216,60,386
"880015261004435456",14,88,217,27,346
"880017678978736129",12,92,311,36,451
"880049704620494848",9,48,274,26,357
"880158771762286592",2,28,16,3,49
"880170602690215936",6,93,39,17,155
"880172859108331520",3,44,19,3,69
"880175585418465284",7,107,152,22,288
"880242238000955392",11,134,54,25,224
"880402366373269504",11,99,56,17,183
"880408582310776832",36,103,386,87,612
"880410114456465411",37,89,1004,174,1304
"880469342835666944",11,120,45,16,192
"880489358431850496",8,92,98,16,214
"880508977590697984",2,13,42,2,59
"880534684479897600",6,83,68,11,168
"880540637358981120",20,168,27,20,235
"880553561008078848",9,123,39,8,179
"880602793341591552",13,95,80,17,205
"880737163247267840",18,164,343,76,601
"880739852286918656",25,177,125,41,368
"880771685460344832",28,87,515,106,736
"880853246126022656",4,63,24,8,99
"880892632142143490",5,96,49,14,164
"881131368520056832",7,66,115,17,205
"881135264441257984",7,111,124,26,268
"881137079958241280",26,178,746,101,1051
"881138485905772549",29,223,187,39,478
"881140479454310401",26,119,588,120,853
"881256428626956288",5,61,27,5,98
"881265792700035073",4,55,67,15,141
"881271748280365056",25,166,350,113,654
"881271809433374721",5,88,144,28,265
"881273362454118400",13,121,406,87,627
"881373634585079808",16,200,145,45,406
"881503147168071680",393,1371,1119,319,3202
"881604490041995271",15,157,231,66,469
"881662619282702338",26,209,231,42,508
"881697281233354753",12,188,93,33,326
"881830110114009089",6,52,70,19,147
"881834692282109953",9,89,64,14,176
"881839523126272000",4,54,75,13,146
"881847676232503297",18,205,324,76,623
"881875263700783104",12,244,90,38,384
"881976958556549120",4,36,65,10,115
"881979394373406720",15,104,112,23,254
"881983493533822976",9,158,225,60,452
"882061157900718081",35,157,277,52,521
"882062572081512449",18,120,158,31,327
"882186896285282304",19,196,146,58,419
"882325456162361344",13,173,104,59,349
"882327018070790144",27,199,209,72,507
"882423634639425536",41,404,41,40,526
"882552631905988609",8,78,204,50,340
"882558219285131265",17,153,108,35,313
"882560030884716544",13,129,145,33,320
"882962893288882176",8,114,30,10,162
"882993144194838528",8,101,47,4,160
"883012994145280000",25,188,118,22,353
"883064346519187456",11,147,60,17,235
"883071945301868544",0,0,22,2,24
"883218784663818241",15,127,88,35,265
"883220875444715520",3,68,31,7,109
"883229270943911936",25,174,385,54,638
"883229754077392896",6,91,108,25,230
"883230130885324802",21,210,248,49,528
"883444736849305600",8,97,41,18,164
"883469033059864578",11,106,89,31,237
"883751888491098112",19,145,68,23,255
"883752778379792386",7,70,70,14,161
"883760134333378561",6,104,39,7,156
"883761448064864257",6,103,66,35,210
"883845492790235136",10,182,60,20,272
"884008221970763776",6,104,57,10,177
"884012097805406208",18,118,216,25,377
"884013689736769536",14,141,55,28,238
"884016887692234753",77,111,391,60,639
"884018776391503872",10,104,43,13,170
"884020939264073728",11,131,167,45,354
"884027201804488704",5,103,77,16,201
"884033889613828096",13,141,183,33,370
"884141905436696576",12,174,139,49,374
"884142582191849474",6,105,39,10,160
"884211874518192128",17,98,231,37,383
"884361623514656769",21,179,293,59,552
"884363456849342464",12,159,215,64,450
"884374529660903424",4,91,165,35,295
"884378624660582405",24,143,477,90,734
"884728971530829824",14,201,254,55,524
"884740553040175104",18,126,166,37,347
"884746435039768576",12,160,24,14,210
"884750055776948225",16,150,94,10,270
"884931352201756672",10,95,324,63,492
"885081181980590084",24,163,383,57,627
"885084555421634561",21,153,368,40,582
"885092844511387654",17,163,86,39,305
"885109663217352704",5,89,118,19,231
"885128373441355777",19,162,404,69,654
"885131482397908992",27,131,545,69,772
"885232527656538113",11,114,64,23,212
"885410010167226370",7,77,66,15,165
"885481504780013568",6,82,27,14,129
"885570979975639040",4,46,27,6,83
"885579818875670528",9,60,61,8,138
"885769944482414593",4,44,29,6,83
"885770227514052608",7,75,150,30,262
"885772254017187840",2,55,57,10,124
"885772727315030020",7,98,84,37,226
"885773130723205120",3,69,126,21,219
"885817217455140864",6,73,33,9,121
"885856351557210112",2,55,14,1,72
"885858247277727746",2,42,29,4,77
"885865609971605508",6,47,101,24,178
"885988016912838656",0,43,42,13,98
"886036222308757504",13,153,58,28,252
"886058483392622592",1,37,96,13,147
"886259363412926464",8,91,33,16,148
"886261674029854721",9,110,133,29,281
"886262474277888002",5,30,117,12,164
"886283456644251652",6,70,140,29,245
"886319322154586112",15,87,77,17,196
"886321948275429381",5,55,135,31,226
"886421324637380609",5,33,77,8,123
"886534810575020032",28,219,469,106,822
"886538703547621376",13,118,116,22,269
"886541955311816705",8,106,174,15,303
"886544734788997125",20,124,415,55,614
"886588838902206464",11,66,308,46,431
"886635676787232768",9,92,27,11,139
"886691926233239556",4,40,91,9,144
"886742955251335168",4,35,12,3,54
"886743367815766021",7,101,162,40,310
"886950594220568576",23,110,624,114,871
"887134287350439936",19,207,481,125,832
"887279050263285761",12,103,317,64,496
"887280380423938048",18,141,438,74,671
"887299895803203584",8,92,207,41,348
"887302632687251456",17,138,468,83,706
"887475373981696000",16,173,199,36,424
"887477071160762369",14,155,315,54,538
"887650824515661824",6,130,268,69,473
"887654816507408384",14,93,482,99,688
"887862941109940225",14,138,144,23,319
"888088029428150272",3,75,63,15,156
"888128621784838144",27,256,308,81,672
"888240051599134721",6,87,83,8,184
"888393378970439682",3,41,74,8,126
"888420461075476480",7,96,66,13,182
"888429879603191811",7,72,161,20,260
"888478670502932480",3,73,37,8,121
"888575966259314691",26,160,263,43,492
"888708453560184832",15,97,183,28,323
"888711488717934592",15,103,136,16,270
"888713231065391104",8,64,54,9,135
"888724194820857857",17,78,408,26,529
"888726438265966592",21,177,439,72,709
"888727293346156546",15,147,216,34,412
"888730468732067841",14,157,351,53,575
"888733031875346432",6,53,206,27,292
"888734848550043648",7,140,139,29,315
"888736256145985536",12,124,337,46,519
"888771440014749697",3,56,52,14,125
"888841724759597057",12,128,60,14,214
"888924192573235201",23,204,61,34,322
"889215815022727168",13,105,239,36,393
"889217183930351621",43,218,689,170,1120
"889273320574783489",12,73,215,31,331
"889274373689028609",18,162,234,53,467
"889279880336166914",9,150,145,34,338
"889435104841523201",26,238,322,56,642
"889438168721874944",16,196,105,34,351
"889467610332528641",25,173,425,91,714
"889473486506385409",18,126,408,48,600
"889474780356915206",14,148,151,35,348
"889579795176181761",9,47,24,12,92
"889599425458327552",5,60,128,15,208
"889654862379589633",9,133,125,24,291
"889672374458646528",4,72,88,14,178
"889673743873843200",5,61,128,20,214
"889675644396867584",11,90,140,40,281
"889788202172780544",9,100,95,12,216
"889790429398528000",24,122,271,102,519
"889792764363276288",23,133,132,28,316
"889794300913045508",7,104,77,17,205
"889796918615920640",9,132,187,27,355
"889798407228989441",217,93,313,33,656
"889800510106107904",20,143,319,62,544
"889821674987761664",9,64,60,5,138
"889822411356602369",5,86,178,20,289
"889824817473605632",7,66,101,18,192
"889867842186649600",8,81,93,13,195
"889871789198802944",6,70,102,10,188
"889925142675062784",1,20,12,3,36
"889929412539543552",34,98,159,22,313
"889972487844491265",2,52,80,15,149
"890060370861334529",2,69,47,7,125
"890069204082151424",3,52,60,10,125
"890162144884514820",5,67,186,16,274
"890168183079960576",12,95,348,51,506
"890193981585444864",60,232,209,59,560
"890196164313833472",62,218,461,59,800
"890197095151546369",51,224,778,99,1152
"890207082926022656",14,91,191,43,339
"890208319566229504",11,84,262,39,396
"890260758050856961",22,248,945,100,1315
"890314337696579584",5,45,58,26,134
"890361489126805504",10,142,117,29,298
"890524387773997056",6,57,151,22,236
"890533442135502849",14,149,216,45,424
"890566339462672385",4,68,82,15,169
"890568797941362690",5,69,169,17,260
"890642377131515904",10,104,105,35,254
"890650237060120576",4,38,30,5,77
"890687451156631555",5,83,31,5,124
"890764622852173826",9,81,359,76,525
"890820505330212864",38,198,1007,170,1413
"890931465885798400",14,83,323,53,473
"890935044474380288",7,62,215,40,324
"890968428370153472",11,73,68,11,163
"890971233159962624",11,78,109,17,215
"891038014314598400",59,172,161,50,442
"891039237319143424",11,96,50,13,170
"891040645581873152",21,111,235,28,395
"891087485111087104",9,92,112,14,227
"891253798500487168",10,119,170,16,315
"891257113565163520",8,121,169,35,333
"891259245106278400",8,107,164,24,303
"891260230876659713",11,117,211,43,382
"891261878005092353",7,104,142,21,274
"891263843908947969",8,111,274,40,433
"891332290474848257",12,119,229,66,426
"891334415347060736",23,202,326,100,651
"891343645529567232",18,136,202,34,390
"891397134662193152",23,160,335,77,595
"891442016294494209",13,118,201,46,378
"891623821702295552",17,169,375,83,644
"891996053611917312",31,289,193,106,619
"891998881009061888",25,248,568,61,902
"892147656319004672",55,144,516,83,798
"892366646542782464",25,185,234,39,483
"892370324616089600",8,117,198,30,353
"892383242535481344",30,182,641,150,1003
"892741272259133441",7,57,46,14,124
"892749228291874816",3,135,78,21,237
"892782712322437120",3,73,63,3,142
"892814520942460928",12,129,145,27,313
"892920397162848257",36,218,375,68,697
"893081237082001409",13,117,170,21,321
"893082107081244672",16,135,114,35,300
"893083735633129472",29,144,560,83,816
"893140445294940160",2,61,75,14,152
"893170489820151808",10,118,49,24,201
"893186623193718784",3,95,26,7,131
"893325503020642305",9,100,83,19,211
"893411790868160514",27,200,50,26,303
"893416615504748544",7,61,44,16,128
"893417795614121985",9,113,71,25,218
"893420123641479168",14,123,131,34,302
"893452922427715584",14,130,200,40,384
"893498883090907137",13,99,61,17,190
"893587008312016896",6,61,44,21,132
"893864420539068417",19,148,164,32,363
"893957896190533632",12,87,60,7,166
"894185208924262401",32,235,172,31,470
"894367017054208001",17,158,195,27,397
"894368024765059073",13,137,61,23,234
"894508048844279809",11,88,117,19,235
"894512983384129536",15,127,159,44,345
"894514535062790144",9,73,62,6,150
"894515865802223616",11,85,90,15,201
"894518002795900928",18,120,255,30,423
"894521737534197762",7,88,153,26,274
"894525428236464128",21,137,219,28,405
"894526670836781056",16,138,260,37,451
"894528885701971970",11,110,293,36,450
"894620077634592769",17,116,100,20,253
"894653195112378368",18,135,174,23,350
"894659355324424192",19,107,307,51,484
"894661651760377856",34,201,478,92,805
"894878812063846400",17,115,119,22,273
"894880193839497216",26,162,150,31,369
"894981661926068228",18,164,257,29,468
"894984126582972416",25,175,559,75,834
"895091395379245056",4,90,93,33,220
"895252459152711680",24,180,367,52,623
"895254168570605568",23,226,282,53,584
"895347654431035393",30,254,234,107,625
"895398465290723329",21,193,106,32,352
"895599179522650112",19,185,274,72,550
"895686351529672704",25,235,334,63,657
"895741164103639042",9,80,138,19,246
"895794792747216896",14,136,284,46,480
"895970429734711298",58,347,458,69,932
"896076107094474752",7,63,49,10,129
"896109655574708224",4,66,54,10,134
"896124861571112960",9,89,67,14,179
"896191069733265408",7,65,61,18,151
"896420822780444672",101,556,765,104,1526
"896431205549318144",13,69,276,14,372
"896452967741747200",4,22,67,9,102
"896467135391596544",11,118,171,37,337
"896481262776360960",35,283,286,47,651
"896488914877165569",12,117,208,25,362
"897041646659014657",8,90,180,20,298
"897044700124909569",8,88,94,9,199
"897048688639574016",15,149,314,23,501
"897079051277537280",32,141,589,76,838
"897218560937922564",12,90,121,23,246
"897220584211439616",5,76,58,12,151
"897221868784168960",3,59,88,22,172
"897223558073602049",32,250,849,165,1296
"897293484884979712",15,159,465,66,705
"897405235924275200",8,42,62,10,122
"897411177583702016",6,49,54,10,119
"897429670278385664",10,60,106,15,191
"897478270442143744",36,160,668,116,980
"897763049226084352",16,101,265,56,438
"897764432369070080",4,56,54,8,122
"897782776468000768",2,47,14,2,65
"897784898865553409",18,159,142,32,351
"897799882802704385",48,317,560,80,1005
"897833223501344769",6,63,94,12,175
"897834894822342656",19,144,385,33,581
"897869174323728385",50,120,685,111,966
"897908198098706433",1,38,162,23,224
"897934811909636096",8,94,61,17,180
"897974118959783937",13,111,267,39,430
"898015350914138112",19,120,86,28,253
"898127175525728256",19,131,201,45,396
"898128290698989568",9,109,122,9,249
"898130328916824064",31,237,551,82,901
"898136462385979392",17,204,230,55,506
"898167282727366656",7,90,77,14,188
"898169407213645824",40,228,549,68,885
"898171544236687361",33,220,424,90,767
"898172999945392131",35,187,607,97,926
"898243270169563136",53,275,374,48,750
"898254409511129088",20,160,746,90,1016
"898522732672933890",18,149,180,24,371
"898528795308642304",21,159,246,62,488
"898531481185689600",26,215,316,48,605
"898547379451740160",15,108,144,39,306
"898567378988015616",11,108,71,24,214
"898718902200418306",6,107,87,19,219
"898771262453026816",22,203,42,20,287
"898870621584596993",45,191,312,44,592
"898874064722427904",14,117,103,31,265
"898964640817983488",23,208,239,37,507
"898988632551370753",24,164,441,31,660
"898990321387925504",8,116,82,8,214
"899008381226299392",31,230,382,60,703
"899008521726861312",48,276,512,89,925
"899466340238491648",24,174,72,33,303
"899623926082535425",10,122,201,25,358
"899625157421039616",17,129,306,53,505
"899798313997926401",4,43,66,25,138
"899833714363949056",10,112,35,20,177
"899841094761848832",9,90,65,33,197
"899945866991206400",8,109,102,30,249
"900074005205528578",17,122,29,17,185
"900086092107571200",12,76,84,33,205
"900150814081036288",16,168,38,25,247
"900225712522657792",11,109,152,24,296
"900229323801735168",18,191,193,22,424
"900236323893673984",7,83,74,17,181
"900251514324647936",13,121,151,18,303
"900346953120141312",22,166,239,48,475
"900352052068401154",17,150,425,49,641
"900354657133801474",7,149,223,35,414
"900435023517499392",12,127,170,27,336
"900521251768213505",8,98,52,10,168
"900694112940290049",10,111,51,12,184
"900695448465399809",10,107,110,21,248
"900706146943717377",13,108,139,22,282
"900708017909506048",9,76,95,22,202
"900708110330978304",22,147,218,34,421
"900714982823821313",25,199,285,65,574
"900768072503623680",7,89,26,10,132
"900802642779267077",7,104,97,12,220
"900875799292776448",10,105,50,12,177
"901029770401546243",10,139,176,46,371
"901031532164468736",13,148,138,29,328
"901032475111116800",13,111,407,37,568
"901044579750825985",9,125,245,42,421
"901057864516734978",14,89,154,30,287
"901108572041433089",10,87,73,12,182
"901112569322237952",6,60,53,8,127
"901161964994539520",12,107,76,19,214
"901188228174184448",13,81,42,14,150
"901190479798312961",3,69,135,22,229
"901205593054162945",12,169,101,25,307
"901259509632573440",32,208,156,31,427
"901305065885114368",3,83,38,12,136
"901404330024218624",5,55,26,3,89
"901407059547226112",8,82,29,8,127
"901411986302488576",11,111,94,17,233
"901531320052051971",15,128,48,26,217
"901777333513854976",15,90,55,23,183
"901782823522185218",8,69,127,20,224
"901791391130554370",18,194,130,22,364
"901795255086968833",5,75,227,30,337
"901797906046439426",12,85,218,24,339
"901802524981817344",19,174,569,65,827
"901804388649500672",17,117,193,35,362
"901814456505831424",4,75,152,16,247
"901816453736919040",9,116,130,35,290
"902503724274331653",20,123,213,55,411
"902507855584092160",10,153,129,41,333
"902875515534626817",26,187,177,48,438
"902881712010653697",20,196,233,33,482
"902885560552960000",25,245,387,108,765
"902889225061896196",10,97,169,35,311
"902978901223366656",28,230,101,25,384
"903059975437733888",18,199,107,31,355
"903348312421670912",32,266,63,44,405
"903587428488839170",45,341,440,150,976
"903597166249246720",12,105,85,22,224
"903600265420578819",17,90,111,21,239
"903603043714957312",17,117,158,44,336
"903705867891204096",26,199,142,34,401
"903766326631698432",23,140,163,26,352
"903770196388831233",17,146,145,48,356
"903778130850131970",16,110,51,21,198
"903980484966752257",15,111,69,24,219
"904025340049285121",22,230,96,47,395
"904160894661296130",36,343,62,26,467
"904174851627286530",9,114,55,17,195
"904176553621307396",16,118,60,24,218
"904177758489776129",41,306,367,72,786
"904211620896886785",23,171,74,16,284
"904305644651634688",27,179,68,29,303
"904307898213433344",24,137,85,23,269
"904309527381716992",26,134,175,38,373
"904375314830249984",27,189,156,45,417
"904377075049656322",45,280,256,79,660
"904745562771259392",24,235,332,69,660
"904899243906879488",24,133,314,54,525
"905038986883850240",34,196,382,54,666
"905047095488516098",37,173,125,36,371
"905170032229056512",25,198,234,52,509
"905228667336499200",42,193,334,71,640
"905381817695526912",15,136,386,40,577
"905383039517282304",34,183,129,40,386
"905383515302264832",15,76,253,31,375
"905488897186172928",21,104,39,13,177
"905512462971232257",21,142,42,11,216
"905571513398693888",6,60,18,5,89
"905582435538219011",5,50,11,2,68
"905586115440242689",21,158,80,14,273
"905603224379559936",14,118,84,16,232
"905770927526432768",21,138,54,24,237
"905775458557538304",12,100,27,11,150
"905788459301908480",61,158,190,59,468
"905856569329504256",4,48,16,3,71
"905880546185814016",9,98,39,9,155
"905888075749974016",7,75,32,8,122
"905958330815926276",31,164,68,17,280
"905967331662319617",20,123,102,21,266
"906133573400481792",18,125,37,13,193
"906134333467045888",22,179,29,11,241
"906135414498631680",18,157,50,18,243
"906136682952568832",18,123,60,13,214
"906139352580972544",17,180,80,21,298
"906170854362447875",33,173,49,15,270
"906320446882271232",32,249,298,43,622
"906543198599876608",30,130,24,17,201
"906634384702291968",24,123,40,16,203
"906669500984041472",15,102,18,9,144
"906712991940399104",39,224,73,29,365
"907303264458362880",20,153,55,14,242
"907311779331690496",44,315,139,23,521
"907588803161939968",30,181,282,42,535
"907592460070768641",23,124,60,21,228
"907675638055743489",22,151,46,72,291
"907698529606541312",9,61,38,16,124
"907928888587808768",17,156,81,27,281
"907930425657626624",24,128,82,28,262
"907946177022369792",20,180,206,26,432
"908154067658174469",18,154,77,27,276
"908160218995068928",37,194,354,69,654
"908161523180285953",24,160,209,61,454
"908272007011282944",36,166,57,50,309
"908274366739345409",34,207,161,71,473
"908276308265795585",104,128,244,145,621
"908278070611779585",43,82,67,92,284
"908285679335034880",12,94,69,21,196
"908406085308096512",11,92,31,9,143
"908409572943126528",15,87,151,24,277
"908413019050463232",20,145,263,50,478
"908413134196572161",9,108,150,25,292
"908438028980490240",24,133,29,12,198
"908494344008749056",17,116,34,18,185
"908640949605163010",12,106,99,15,232
"908642277987356673",28,158,125,16,327
"908643633901039617",23,149,264,26,462
"908645126146265090",27,172,179,24,402
"908646582807089152",23,156,295,26,500
"908651641943003136",36,269,496,72,873
"908676979561570304",14,139,47,30,230
"908724382440284160",12,86,30,14,142
"908734537311678464",47,357,47,65,516
"908768057140629506",18,120,132,15,285
"908796281002307584",15,102,44,13,174
"908841360131743744",34,200,38,18,290
"909381488445190145",7,74,21,9,111
"909384837018112000",44,287,174,56,561
"909385782275788800",5,46,35,7,93
"909393531143380992",13,118,68,14,213
"909401572341370881",17,113,88,24,242
"909767654432526336",11,99,16,6,132
"909768037787717633",6,68,23,9,106
"909818335130525697",10,76,19,6,111
"909823695299981313",16,124,53,17,210
"909922763774861314",8,107,39,14,168
"909975689838731264",10,55,27,5,97
"909995135009804288",17,104,62,4,187
"910002272825831425",10,52,23,13,98
"910101538336583680",14,125,105,37,281
"910192375267561472",16,169,123,40,348
"910219338044657664",19,147,89,31,286
"910233418474098688",57,213,154,23,447
"910263274918367236",10,84,84,24,202
"910312303635116033",5,63,20,16,104
"910328626075389952",23,122,39,11,195
"910330501411590146",12,100,120,35,267
"910331061409902592",7,51,35,12,105
"910332992756834304",34,211,328,77,650
"910447064944955392",6,80,47,11,144
"910453612630900736",14,172,135,34,355
"910454516557983744",9,84,63,10,166
"910458657179086848",3,42,53,16,114
"910476107287269376",9,80,152,42,283
"910477734635286528",7,105,133,17,262
"910480918816739328",10,58,81,22,171
"910524897515905025",5,62,21,15,103
"910551350408241152",6,45,21,6,78
"910580644597649409",10,73,59,5,147
"910632095088889857",7,94,63,14,178
"910665452048838661",8,89,79,19,195
"910671525543645185",13,95,293,22,423
"910703407555600386",15,95,51,9,170
"910885156373721092",4,43,6,0,53
"910885755320459264",5,35,14,2,56
"910898047931912192",7,53,27,8,95
"910926223684931585",13,138,54,20,225
"910992971620864004",6,54,70,32,162
"910993665568526337",7,112,81,20,220
"911173124976193536",17,123,237,41,418
"911175246853664768",37,195,245,36,513
"911175765718421504",9,79,72,14,174
"911179462745710593",34,186,537,62,819
"911189860769255424",22,134,275,38,469
"911193223921635335",8,61,87,22,178
"911265133279809536",5,69,29,16,119
"911287725847908352",9,109,25,7,150
"911338971250216960",7,61,210,49,327
"911541328013676544",19,215,183,69,486
"911543222731706368",13,150,90,30,283
"911545480651378689",3,104,132,34,273
"911546774267006976",5,114,128,23,270
"911549099752804357",9,144,90,24,267
"911549980946714624",3,72,73,21,169
"911572182060453893",107,353,1092,210,1762
"911654184918880260",64,425,543,102,1134
"911655987857281024",54,344,656,115,1169
"911700914997792769",20,149,162,42,373
"911711539815702529",36,218,205,47,506
"911717004222091264",26,248,191,55,520
"911718138747727872",55,336,612,148,1151
"911789314169823232",48,202,457,75,782
"911904261553950720",54,406,589,136,1185
"911911385176723457",46,283,601,132,1062
"912018945158402049",31,222,532,88,873
"912019957243883520",48,332,273,48,701
"912037003923005440",56,458,593,110,1217
"912079629648883712",16,108,163,19,306
"912080538755846144",43,343,601,140,1127
"912101775221706752",21,197,221,39,478
"912276850793213952",40,324,284,56,704
"912278438127525888",33,191,292,50,566
"912280282224525312",57,501,567,101,1226
"912281550712135680",17,115,145,22,299
"912301271817838593",61,586,440,65,1152
"912443217227976704",23,133,135,22,313
"912443607084404736",31,191,359,74,655
"912443924979077120",18,229,411,98,756
"912478274508423168",28,113,349,50,540
"912479500511965184",20,74,99,16,209
"912481556127780865",17,74,231,24,346
"912487929783754755",26,250,369,108,753
"912494675206053888",0,0,100,27,127
"912624892239077376",18,150,185,46,399
"912626731357540353",27,171,340,60,598
"912629775629418501",18,133,139,30,320
"912631781098221568",0,0,66,11,77
"912636538156146688",14,115,47,24,200
"912651215997202432",23,137,79,19,258
"912664574461120512",26,146,476,124,772
"912670906828443648",0,0,53,12,65
"912711807709667331",8,71,52,3,134
"912779672257261569",6,60,35,8,109
"912792478096302080",17,98,101,14,230
"912825663694016522",7,54,18,3,82
"912836917296877569",13,72,52,9,146
"912848241535971331",49,325,211,50,635
"912863676792786946",16,157,126,18,317
"912994446219898880",43,135,126,16,320
"912997506900021248",15,158,167,43,383
"913003340451188737",13,92,98,13,216
"913004378486984704",13,121,221,23,378
"913034591879024640",18,124,282,44,468
"913035855509491712",24,152,589,69,834
"913117797231857664",15,93,133,33,274
"913187235452690432",19,133,120,28,300
"913220484640182272",19,144,189,46,398
"913371663789625344",20,160,260,48,488
"913403237033742336",27,146,153,44,370
"913488283321159680",30,144,9,11,194
"913549374227181568",13,99,56,13,181
"913550237377138688",20,117,204,33,374
"913554705816711168",21,117,142,20,300
"913589799411490817",21,188,133,27,369
"913723771336392704",14,153,110,21,298
"913724766208610304",16,77,213,26,332
"913757869627133953",15,131,86,13,245
"913760243770896389",15,92,111,16,234
"913821956625059840",16,87,46,10,159
"913856413541138432",4,53,45,16,118
"913888647631577088",15,105,84,14,218
"913892019847778305",10,46,43,2,101
"914087234869047296",34,171,714,84,1003
"914089003745468417",28,112,692,95,927
"914089888596754434",20,127,436,45,628
"914090947180470272",11,108,83,14,216
"914094625488502784",22,165,264,42,493
"914096428879933440",12,108,204,42,366
"914099295963553792",22,216,521,72,831
"914189344533024768",15,143,271,33,462
"914208123564494850",16,109,68,12,205
"914210813237489666",10,115,44,6,175
"914214237584674816",8,104,52,3,167
"914216744385904640",21,133,432,37,623
"914217117695795201",13,82,30,7,132
"914217477495717889",9,61,84,10,164
"914217658517737472",15,113,213,22,363
"914227642131509248",21,145,348,45,559
"914252271982178306",10,116,154,27,307
"914255264282480640",25,228,633,84,970
"914269704440737792",8,54,529,64,655
"914310901855129601",27,237,212,70,546
"914465475777695744",14,154,306,45,519
"914466534365569025",12,133,177,22,344
"914467502251528192",11,128,81,8,228
"914497877543735296",53,155,366,60,634
"914497947517227008",21,104,244,34,403
"914565910798782465",58,283,710,106,1157
"914661855947366406",13,112,87,15,227
"914810093874671617",129,620,499,90,1338
"915179824012042241",36,367,333,67,803
"915326171063242752",16,124,93,17,250
"915335645719121920",8,74,26,6,114
"915371086249971712",25,159,235,41,460
"915379231454003200",17,127,108,14,266
"915523382686478337",17,120,244,29,410
"915539424406114304",28,301,525,148,1002
"915589297096536065",24,161,346,38,569
"915596990674849792",20,148,376,40,584
"915604746936967168",13,110,151,29,303
"915722355757985792",31,202,72,23,328
"915745470689005573",18,199,61,10,288
"915890389269254145",17,138,136,36,327
"915890821228048385",10,93,43,11,157
"915894251967385600",32,172,551,82,837
"915896809536589824",51,316,305,53,725
"915907150333009920",15,169,354,37,575
"916120435762266114",26,206,208,41,481
"916620603741868032",16,129,100,24,269
"916622087606980609",15,105,90,33,243
"916634286811435008",19,124,374,65,582
"916635236238274561",18,162,580,88,848
"916638685914951680",19,109,143,53,324
"916655548623413248",24,131,209,47,411
"916665576940097536",18,134,75,13,240
"916747884716011521",7,63,55,8,133
"916750042014404608",14,139,83,12,248
"916751271960436737",19,134,322,62,537
"916763438805848066",9,109,82,11,211
"916780428253687808",15,103,158,29,305
"917024076165734401",5,51,26,8,90
"917026789188399105",17,113,288,42,460
"917029060471152640",8,99,89,7,203
"917030148867682304",10,107,228,34,379
"917091286607433728",36,234,635,93,998
"917114761057357824",11,90,45,6,152
"917130468025348096",18,142,230,39,429
"917172144710103040",39,165,737,95,1036
"917177470532636672",15,104,105,22,246
"917341511754436609",19,152,171,35,377
"917345200414035969",26,162,481,63,732
"917458408927842305",20,128,217,20,385
"917568245854605313",48,284,298,59,689
"917694644481413120",26,290,321,78,715
"917695847063805952",16,187,194,34,431
"917698839846576130",27,206,228,51,512
"917701841466593280",25,163,482,75,745
"917724872905777155",11,87,198,16,312
"917734186848579584",23,112,449,46,630
"917894963832246272",21,148,56,18,243
"917921548677328896",21,131,91,21,264
"917923131003719681",16,139,90,15,260
"918058910673760258",24,178,105,20,327
"918060313748164608",12,103,50,7,172
"918061437750267904",17,130,174,19,340
"918062778522505216",17,159,192,29,397
"918065431939829760",25,176,354,69,624
"918110279367643137",27,151,166,24,368
"918112884630093825",42,171,871,124,1208
"918201878479073280",29,179,215,31,454
"918224393062551552",7,47,42,5,101
"918227740700102657",10,92,244,36,382
"918257107182473216",12,100,87,12,211
"918263984029085697",6,49,53,6,114
"918267396493922304",36,141,562,76,815
"918275261011038210",17,108,117,20,262
"918417002733154305",6,61,83,18,168
"918428456869916672",16,72,126,17,231
"918430769776914432",15,77,76,9,177
"918432809282342912",40,104,650,85,879
"918457595618365441",23,133,456,60,672
"918523263554412544",16,115,127,18,276
"918541193037967361",18,122,124,20,284
"918571860308254720",13,97,28,10,148
"918630610167529472",24,156,357,54,591
"918647067224035334",18,126,158,20,322
"918772522983874561",15,113,287,31,446
"918796079243677696",10,94,121,21,246
"918797009133465600",14,122,295,27,458
"918806396875010048",24,174,150,42,390
"918808798059483136",19,82,244,34,379
"918876603148652544",8,146,41,15,210
"918885859230875649",17,169,299,42,527
"918894502185787392",11,89,73,9,182
"918901399080935424",12,110,107,26,255
"918960024256434176",5,68,63,19,155
"919003314674634752",11,79,43,13,146
"919005534883328000",8,78,92,18,196
"919007577681354752",15,138,115,19,287
"919009334016856065",11,95,205,26,337
"919012714827145216",16,139,238,36,429
"919160558712172544",25,165,234,38,462
"919162619889704961",25,188,511,73,797
"919313707355787264",20,124,85,16,245
"919554724512387072",10,94,144,20,268
"919560102725738498",14,105,254,34,407
"919900022409449474",9,106,124,19,258
"919901190376259586",14,120,178,23,335
"919908143475412993",21,181,75,18,295
"919909494200528897",13,174,144,26,357
"919910256624447493",16,145,180,33,374
"919914000959397888",37,228,537,87,889
"920069869365878785",11,93,91,11,206
"920268091329859585",21,65,173,24,283
"920322631412473856",9,111,83,18,221
"920340060947574786",3,32,24,2,61
"920363714062274560",7,47,37,4,95
"920406959320371200",13,115,257,50,435
"920408108194783232",12,148,367,58,585
"920425069964349445",22,194,157,48,421
"920425695507042305",12,136,119,31,298
"920450535005851648",4,82,43,5,134
"920474831749025795",19,174,182,21,396
"920595564064100352",23,176,100,29,328
"920597192666157057",19,146,98,38,301
"920599916371693568",11,107,94,23,235
"920604520572424193",25,202,208,37,472
"920606910109356032",27,191,450,104,772
"920611770775064576",31,212,905,140,1288
"920645935981613057",7,122,115,25,269
"920667567030710272",6,86,90,11,193
"920695565578592256",11,76,119,13,219
"920716270395371521",5,63,39,4,111
"920733077349064707",9,92,29,7,137
"920751863426842625",20,186,433,59,698
"920776302231244800",22,142,101,19,284
"920794597265088512",8,82,61,20,171
"920847844759699456",22,141,309,49,521
"920966294035451904",13,107,112,30,262
"920972261032648705",39,318,213,54,624
"920981920787386368",30,193,302,52,577
"920988223362469891",15,188,176,36,415
"921113816053755904",16,94,70,13,193
"921189980843663360",15,105,32,16,168
"921207772233990144",26,153,504,79,762
"921209530628956161",9,93,87,9,198
"921242760685998080",13,99,78,18,208
"921317883321430016",17,132,54,14,217
"921319017826091008",14,128,85,10,237
"921323063945453574",30,204,263,58,555
"921443729990397952",11,114,60,17,202
"921448521617821701",9,56,20,1,86
"921483820288921601",14,132,120,20,286
"921524504836395008",17,118,192,22,349
"921705862992887808",20,131,72,17,240
"921709468055896064",23,144,339,55,561
"921716470140325889",113,443,306,118,980
"921724821939130369",17,115,161,39,332
"921726400922619904",22,177,208,24,431
"921780758372642816",10,90,38,14,152
"921828280998744066",31,196,138,33,398
"921829947093733376",20,144,298,52,514
"921848853090983938",24,149,399,71,643
"921888248707846144",13,113,130,31,287
"921889525881819136",21,138,157,20,336
"921891186352287744",23,134,202,38,397
"922067676708638721",7,59,102,13,181
"922070659093671936",21,197,349,55,622
"922072236592435200",33,199,549,92,873
"922428118685581313",27,222,147,29,425
"922430688703451136",23,201,482,114,820
"922440008971292672",23,143,726,109,1001
"922603042796654592",15,123,100,17,255
"922798321739161600",27,165,276,52,520
"922799981874089985",19,99,168,18,304
"922817539251556353",13,102,194,37,346
"922828476872318976",17,96,206,36,355
"922830229525225477",19,102,345,65,531
"922833943749103621",24,159,181,26,390
"922903426434064384",9,47,65,14,135
"922951009277825024",19,135,312,47,513
"923147501418446849",22,206,233,48,509
"923149037523566592",15,138,128,20,301
"923149793974775810",14,98,206,20,338
"923150966551171073",28,145,166,28,367
"923165619868131329",16,118,304,40,478
"923212567232774145",12,99,75,14,200
"923237600009342978",9,48,24,8,89
"923244308848881665",12,69,75,7,163
"923268967728386049",9,75,57,9,150
"923272793457913857",9,79,37,9,134
"923277142271684609",48,236,161,43,488
"923312613584289792",4,65,23,4,96
"923365521847934976",13,92,97,24,226
"923392161634275328",14,110,70,31,225
"923546192511946752",9,76,31,7,123
"923551572218572802",7,105,143,10,265
"923552633633337344",8,108,104,7,227
"923557515828310020",14,116,149,22,301
"923566287263068161",27,203,122,41,393
"923662988833427458",20,132,77,33,262
"923720632122200064",14,81,62,13,170
"923866515358789633",15,94,158,31,298
"923866849451888640",7,59,59,17,142
"923869147091451904",10,75,33,7,125
"923871062072295427",9,90,13,25,137
"923876612013248512",23,167,158,33,381
"923894747793580033",10,86,36,8,140
"923905540291522560",34,233,600,103,970
"923920535607828481",7,72,47,7,133
"923925428372492288",12,110,49,7,178
"923976737788227584",9,87,48,6,150
"924011278804357120",17,115,100,12,244
"924022268929433600",10,71,166,20,267
"924056425298571265",10,83,29,5,127
"924064610038272000",25,142,118,24,309
"924096747122634752",24,212,300,48,584
"924249943719727104",19,187,124,28,358
"924251519121346560",29,188,193,32,442
"924284026394959872",14,78,77,15,184
"924382514613030912",26,127,57,14,224
"924382752941756421",14,74,26,5,119
"924382919845666816",14,79,67,17,177
"924397489037430784",13,137,27,35,212
"924400308834455552",35,214,561,90,900
"924414387343028224",19,135,222,31,407
"924625061100867584",12,104,246,37,399
"924635359480303616",36,251,293,61,641
"924637600094326784",19,182,236,35,472
"924639422066384896",21,137,217,27,402
"924641278947622913",38,194,585,82,899
"924649059520073730",27,186,519,64,796
"924963492645437441",41,315,440,75,871
"924966722544848896",11,58,132,8,209
"925005659569041409",56,288,833,133,1310
"925006418989715456",43,169,995,124,1331
"925333956110757888",20,105,256,38,419
"925335577217683456",23,101,448,36,608
"925336826717593600",18,144,262,42,466
"925363340553211909",21,138,204,32,395
"925364408364171265",13,93,151,23,280
"925373392827666432",10,92,48,11,161
"925388990177562625",6,53,21,3,83
"925394079982280704",18,113,76,28,235
"925424931390873602",13,86,61,12,172
"925440868575797252",8,49,57,6,120
"925447637708496897",9,87,199,12,307
"925474979914887168",35,187,205,43,470
"925533433597775873",17,122,95,20,254
"925534445393928199",40,299,383,79,801
"925684982307348480",32,310,371,61,774
"925686558304464897",23,224,157,43,447
"925688931823300609",15,171,190,34,410
"925716689064427520",7,65,28,15,115
"925739132579729420",22,150,275,45,492
"925740081805217792",14,74,98,23,209
"925806343855984647",7,103,51,7,168
"925818295462322184",6,52,24,7,89
"925818338172915712",5,41,27,4,77
"925833462426292226",10,105,25,4,144
"925845735089889280",8,60,23,4,95
"925907651350941696",9,91,33,13,146
"925910265060831232",23,187,167,31,408
"925913030159937537",8,78,109,13,208
"925916863401480192",2,43,22,4,71
"925925920304779264",10,67,95,11,183
"925931294705545216",57,274,258,79,668
"926053970535243777",18,83,97,19,217
"926054936718307328",22,114,206,51,393
"926139726129704960",10,82,18,4,114
"926155393490878464",19,132,60,19,230
"926157911151214592",16,109,55,8,188
"926176823117074433",10,81,18,10,119
"926185468911382529",11,122,33,15,181
"926238774773862400",14,115,118,31,278
"926247543801044993",37,193,108,39,377
"926249604936556545",26,198,187,70,481
"926259330474704900",20,147,158,39,364
"926260114146889728",7,73,116,31,227
"926401530013642765",29,163,245,49,486
"926403023861141504",18,196,225,61,500
"926404584456773632",15,150,71,20,256
"926406490763784194",27,248,297,75,647
"926415703476928512",23,156,139,31,349
"926417546038923264",28,237,508,63,836
"926419647708258304",15,107,59,15,196
"926421589159182339",12,111,47,13,183
"926456069047582721",25,120,161,19,325
"926456409260285952",19,116,159,21,315
"926460439000698880",12,107,217,49,385
"926481563214376961",27,215,180,35,457
"926484660946862085",18,132,110,15,275
"926492915626663939",30,361,413,96,900
"926647019455766528",12,113,54,12,191
"926707692395102219",17,165,49,21,252
"926789876556500992",33,295,248,44,620
"926793510723796993",22,109,71,7,209
"926973117708296192",10,125,48,20,203
"927007332743172098",12,124,46,15,197
"927059219370643456",19,112,121,25,277
"927075137131896832",8,77,28,5,118
"927077305876434945",9,102,104,11,226
"927265906086031363",62,334,482,74,952
"927397233741492225",17,136,244,21,418
"927523335956848640",13,100,40,5,158
"927644826006425601",17,171,118,14,320
"927645648685551616",13,114,39,8,174
"927648870796070912",14,97,87,13,211
"927672843504177152",23,109,82,9,223
"927673257230327808",11,61,79,15,166
"927802776737984513",9,87,25,5,126
"927844454957850625",17,111,31,11,170
"927847349648609280",14,98,82,4,198
"927847471321141249",6,54,56,4,120
"927851387857367040",14,97,225,26,362
"927851452185407490",4,50,54,6,114
"927852358209622016",14,102,166,14,296
"927906208203276288",13,128,23,16,180
"928016742575738882",9,93,48,12,162
"928064591665467393",7,85,87,20,199
"928074747316928513",25,159,574,56,814
"928083235040579584",3,50,35,8,96
"928097146993369088",10,98,66,9,183
"928097817037627393",8,73,19,4,104
"928098389966942208",8,80,64,7,159
"928105793366392832",12,84,41,7,144
"928124338343202816",9,77,65,11,162
"928267692645036032",11,84,28,3,126
"928279728125108225",21,171,94,23,309
"928286153672970240",13,79,38,8,138
"928325667556548608",38,281,643,103,1065
"928519663780208640",23,136,64,20,243
"928622838487007260",19,158,106,22,305
"928769154345324544",31,204,259,37,531
"928770248370728960",14,107,58,11,190
"928793643367960576",12,117,83,21,233
"928861178113040385",7,59,82,24,172
"928918183104225280",14,94,39,7,154
"928922787938385920",7,67,17,1,92
"928926863375794176",5,77,14,7,103
"928931835664465921",9,97,18,10,134
"928936220360503296",13,119,45,6,183
"928969836897583104",29,252,42,23,346
"929320777668628480",30,301,134,26,491
"929326786709807105",8,89,34,10,141
"929492038231429120",18,145,30,9,202
"929492850101940225",8,71,51,11,141
"929503025512693760",16,126,67,16,225
"929503641014112256",52,243,634,92,1021
"929509950811881472",28,214,328,53,623
"929511061954297857",360,741,1107,219,2427
"929655283181391874",10,64,36,12,122
"929670192434745344",11,77,31,7,126
"929717762422988801",8,93,50,9,160
"930049882949345281",7,63,20,6,96
"930050967067820032",12,116,126,23,277
"930087113764327424",17,91,129,13,250
"930089374187950081",19,140,146,34,339
"930259298407419904",13,141,146,40,340
"930301344342265857",9,105,24,4,142
"930304414564352000",15,143,71,15,244
"930305984077156352",5,75,51,6,137
"930320191699017730",23,172,292,47,534
"930346433177378817",16,134,229,37,416
"930362633852735488",8,87,22,6,123
"930490487903084544",18,137,64,24,243
"930657178544984066",9,86,76,28,199
"930744931609694208",15,135,117,16,283
"930747213659197441",6,71,75,9,161
"930748627642998784",34,205,387,72,698
"930750650010480640",3,33,41,3,80
"930751807101562881",11,74,85,21,191
"930815626460921856",93,275,461,149,978
"930836707095863296",15,101,116,19,251
"930837616714571776",15,128,103,15,261
"930840960346611712",17,108,225,31,381
"930981685658902528",21,203,380,65,669
"930982399202217984",11,98,125,10,244
"931122234437046272",18,154,56,18,246
"931123400810037248",15,142,82,16,255
"931140567089721344",14,156,44,10,224
"931223807037263873",11,106,43,9,169
"931254609041068032",12,124,104,29,269
"931355543096233985",12,93,89,11,205
"931357870024687616",30,169,1275,129,1603
"931360196554821632",21,156,506,61,744
"931469365538672640",14,119,104,19,256
"931477193255014400",16,177,287,40,520
"931538234169069568",20,152,120,19,311
"931661592135168000",9,87,45,19,160
"931685146415255552",74,177,310,153,714
"931877599034388480",52,347,783,133,1315
"932303108146892801",135,473,780,269,1657
"932388590344196096",17,139,496,61,713
"932392209445457920",36,221,332,82,671
"932397369655808001",19,101,212,56,388
"932420488642617344",31,300,152,43,526
"932433668068528131",11,129,198,39,377
"932570628451954688",37,289,537,123,986
"932578255810498560",13,156,243,25,437
"933038654171344896",14,123,97,40,274
"933105158275325952",17,117,98,19,251
"933280234220134401",60,213,562,103,938
"933282274937733126",59,235,301,72,667
"933285973277868032",27,196,292,79,594
"933301876975718401",20,140,234,34,428
"933319309551685633",13,96,48,13,170
"933446283632824321",15,96,150,20,281
"933448074348900354",12,147,37,20,216
"933517194142584833",10,87,90,12,199
"933658521828315136",35,358,471,99,963
"933659179348299776",6,7,47,3,63
"933662564587855877",24,251,250,33,558
"933692459351265280",8,77,51,10,146
"933720598383026176",21,196,118,47,382
"933831194558582784",13,96,28,9,146
"933837062293291008",20,170,384,54,628
"933918671503753216",15,110,86,12,223
"933921775984967681",19,129,41,9,198
"934026050388013056",17,117,243,40,417
"934029886842458112",20,99,107,23,249
"934031535757582336",31,130,265,35,461
"934080974773776384",33,214,100,24,371
"934131805409697792",28,148,225,27,428
"934189999045693441",97,228,1289,142,1756
"934507210385829888",21,99,51,15,186
"934539256940417024",15,139,251,36,441
"934542257222451206",11,87,67,17,182
"934551607596986368",34,222,670,104,1030
"934563828834164739",28,166,273,28,495
"934781939088629761",22,251,567,77,917
"934792302341521408",16,154,303,30,503
"934896989539586054",34,297,729,116,1176
"934961858380955648",17,170,239,42,468
"935147410472480769",74,256,921,145,1396
"935150368207654912",13,121,172,19,325
"935152378747195392",20,149,288,38,495
"935339687006429185",14,140,178,27,359
"935340092583006208",12,92,62,12,178
"935489831005810688",20,164,262,55,501
"935493619204620288",16,172,273,60,521
"935513049729028096",22,185,336,83,626
"935545697360891904",9,56,48,10,123
"935632396841562112",10,82,58,9,159
"935636972252618753",8,102,62,10,182
"935640578007687168",7,82,56,11,156
"935686205429157888",27,183,198,44,452
"935701139198181376",16,172,157,30,375
"935712056690577414",14,146,125,27,312
"935712632409030656",7,57,52,9,125
"935713791765110785",17,120,111,18,266
"935833914761007114",10,82,50,8,150
"935838073618870272",19,127,152,36,334
"935841679977910272",17,132,201,26,376
"935844881825763328",40,191,736,82,1049
"935874566701842434",30,185,413,41,669
"935881037254725632",20,161,86,28,295
"935883355547160577",14,102,133,16,265
"935940131311190021",11,71,93,6,181
"936005585019002887",12,119,125,15,271
"936014271858831361",9,105,94,16,224
"936032275980079104",9,116,86,16,227
"936037588372283392",28,166,264,43,501
"936037938898636800",21,197,140,19,377
"936039501474025473",13,155,310,50,528
"936052257392676864",13,182,151,28,374
"936058006659321858",25,315,303,48,691
"936203511037136897",14,125,109,6,254
"936206961728786432",13,98,102,9,222
"936209447747190784",12,116,115,15,258
"936219599422574592",14,138,125,17,294
"936260193536573440",23,203,237,35,498
"936315571708289026",12,115,83,9,219
"936339260218724353",8,81,33,5,127
"936351772603568130",8,128,75,12,223
"936393574433939456",25,235,249,60,569
"936395008139198464",43,409,295,54,801
"936437372706836480",45,430,219,97,791
"936551346299338752",34,289,129,49,501
"936553863255031809",28,242,210,47,527
"936555753946705920",9,144,340,35,528
"936688444046266368",61,208,466,63,798
"936713881711529986",14,129,225,27,395
"936864840240398337",16,134,202,43,395
"936941673124425728",24,249,351,68,692
"937007006526959618",60,232,789,90,1171
"937065834635292673",34,199,193,26,452
"937136868608626689",8,116,60,33,217
"937141061343956992",35,380,421,100,936
"937142713211813889",30,251,505,79,865
"937145025359761408",28,220,201,44,493
"937279001684598784",25,157,380,33,595
"937297341266190336",14,167,87,12,280
"937301085156503552",22,202,181,35,440
"937305615218696193",22,257,436,62,777
"937309279257792512",33,294,255,49,631
"937314665176207360",38,303,452,76,869
"937641904338063361",19,201,471,54,745
"937652739001212928",13,183,291,35,522
"937653535486959616",11,124,184,19,338
"937661677700550656",19,159,310,40,528
"938102355878440960",8,117,216,26,367
"938184577255919623",9,104,177,22,312
"938422792080457731",42,329,443,67,881
"938440878577856512",22,126,59,13,220
"938469354089385985",17,80,82,16,195
"938517073508163584",20,258,218,59,555
"938756989542457344",9,77,253,34,373
"938786402992578560",24,175,98,24,321
"938804374079459329",15,185,51,17,268
"938861758038577152",8,74,24,4,110
"938873956345499654",6,94,35,9,144
"938878398608433152",15,93,60,23,191
"939005659982348291",8,90,56,5,159
"939006911629869056",30,381,222,54,687
"939120304542101505",12,136,190,36,374
"939149296389251072",15,137,394,44,590
"939152197090148352",26,168,131,22,347
"939189419386470401",15,101,275,50,441
"939208571253862400",10,148,134,15,307
"939274666404909056",1,76,60,15,152
"939299624875118592",6,56,84,13,159
"939355447273906182",14,177,111,26,328
"939375570919612416",19,161,144,30,354
"939475127552618496",8,126,139,23,296
"939477807813595136",9,103,206,26,344
"939480342779580416",14,187,186,41,428
"939485131693322240",32,268,630,85,1015
"939521466634326016",7,88,97,13,205
"939560154269405184",13,116,136,16,281
"939564681743814661",7,81,33,15,136
"939616077356642304",19,172,182,44,417
"939634404267380736",21,201,344,63,629
"939642796289470464",13,129,66,13,221
"939680422493073408",25,274,167,71,537
"939849867438034944",23,250,231,43,547
"939851058788134913",17,154,204,39,414
"939967625362276354",25,249,553,81,908
"940223974985871360",32,251,683,100,1066
"940554567414091776",30,298,521,91,940
"940567812053053441",39,205,1149,132,1525
"940584383605563392",27,178,714,84,1003
"940588025964265472",13,189,249,36,487
"940706127309926400",18,154,125,19,316
"940795587733151744",72,214,726,87,1099
"940904649728708609",30,137,767,77,1011
"940930017365778432",33,239,663,98,1033
"940955920967880704",19,193,407,83,702
"941094961482780672",25,115,180,30,350
"941291666564141057",15,148,127,30,320
"941353395121741825",19,163,180,30,392
"941400670766321666",11,114,63,10,198
"941404173433794561",14,169,108,23,314
"941406242785955841",20,232,212,42,506
"941417725833998340",5,73,45,11,134
"941667918214987776",11,97,30,9,147
"941723524921724928",11,69,58,6,144
"941756992070307845",17,140,62,14,233
"941789515248750592",18,146,50,18,232
"941820213518938112",9,111,81,20,221
"941868639199916037",13,134,75,13,235
"942044657613230080",19,206,221,27,473
"942123433873281024",8,117,178,31,334
"942130137734242305",5,87,91,20,203
"942439739264831488",15,173,203,40,431
"942503059103604736",8,78,81,22,189
"942551516564639744",11,111,50,10,182
"942717030091943936",16,155,319,41,531
"942721681130483712",2,43,132,15,192
"942827072824672262",36,178,317,57,588
"942829676699021312",17,125,61,12,215
"942840800853024770",7,77,25,4,113
"942851788461563906",10,100,87,18,215
"942854056162332677",5,72,141,15,233
"942857031693799425",7,75,95,18,195
"942881716913438720",6,71,56,7,140
"942882250089271297",5,76,27,8,116
"942883507868782592",15,188,119,36,358
"942904686125965312",11,121,58,12,202
"942921051721338880",12,109,99,24,244
"943074475209355264",26,211,145,17,399
"943079382163353600",12,123,104,17,256
"943135588496093190",26,242,137,30,435
"943213901625294849",19,246,292,46,603
"943362605258813441",30,293,188,60,571
"943489378462130176",17,173,176,23,389
"943521141062238208",17,160,122,32,331
"943534069287194626",9,120,71,14,214
"943543958730309633",16,196,212,44,468
"943598090069536768",19,215,207,40,481
"943819430735372289",23,239,185,39,486
"943824695144697857",16,164,235,33,448
"943842608631238656",12,162,93,17,284
"943856675294982145",15,176,253,49,493
"943908041803657216",12,116,91,30,249
"944187730564714497",20,204,137,44,405
"944188445748015105",5,76,52,5,138
"944192071535153152",33,225,118,34,410
"944210183089254400",22,139,131,31,323
"944222157218942978",18,169,203,52,442
"944222979147337728",24,151,100,32,307
"944247868126318593",17,168,210,36,431
"944276471614509057",12,158,112,25,307
"944308373373308929",19,144,72,12,247
"944308491887316992",9,110,93,23,235
"944329684032081921",23,220,243,55,541
"944665687292817415",31,285,340,61,717
"944666448185692166",29,177,214,65,485
"944667102312566784",13,112,137,21,283
"944700332881440769",19,174,237,43,473
"944703626454487042",22,139,299,35,495
"944906847970119680",30,241,228,54,553
"944927689638662145",36,245,514,94,889
"945030174290186241",25,186,253,44,508
"945126026824298497",59,373,1132,169,1733
"945140007572004870",30,245,104,67,446
"945287222210781184",44,404,168,158,774
"945437479863291904",24,274,315,77,690
"945624910898122752",16,174,200,43,433
"945646491955290113",30,294,552,79,955
"945780569388015616",23,224,244,50,541
"946151080546750465",0,0,51,19,70
"946156544927977477",9,175,118,31,333
"946201376652169220",14,165,66,18,263
"946210723528572930",14,184,109,26,333
"946401576381505536",17,134,312,44,507
"946415026402988033",20,191,154,29,394
"946416486054285314",27,238,163,62,490
"946460939578167296",19,209,66,26,320
"946519720450252800",15,131,198,31,375
"946531657229701120",100,444,1541,227,2312
"946724075157651457",25,206,335,51,617
"946728546633953285",26,262,339,108,735
"946731576687235072",42,324,390,98,854
"946949708915924994",40,294,274,37,645
"947180713236934657",15,170,51,17,253
"947181212468203520",17,170,116,20,323
"947213895286054914",11,129,99,13,252
"947235015343202304",45,376,528,112,1061
"947236393184628741",17,226,153,44,440
"947328044821336070",13,105,72,11,201
"947453152806297600",24,197,107,26,354
"947458942719979520",8,116,193,31,348
"947461470924820480",21,247,465,64,797
"947536951464333318",16,193,42,15,266
"947544600918372353",22,251,132,50,455
"947588263103139841",22,209,110,36,377
"947592785519173637",48,376,439,109,972
"947614110082043904",23,288,192,74,577
"947802588174577664",52,332,142,83,609
"947810806430826496",23,208,81,30,342
"947824196909961216",13,155,198,37,403
"948164289591902208",20,181,83,17,301
"948174033882927104",39,304,371,69,783
"948188264858603520",6,127,40,6,179
"948189482284707840",7,127,131,16,281
"948194400114487296",10,130,52,13,205
"948195478428102657",22,136,573,56,787
"948202173049049088",12,149,74,12,247
"948205689683562496",11,121,128,20,280
"948211438472089600",23,156,295,45,519
"948255367393349634",14,126,78,13,231
"948318907848413184",13,104,68,16,201
"948322496591384576",23,177,50,41,291
"948322497602220032",13,139,61,29,242
"948355557022420992",184,669,1251,208,2312
"948359545767841792",74,309,859,155,1397
"948404303072460800",15,189,256,30,490
"948548807612084224",24,202,187,34,447
"948722170531893248",8,138,42,11,199
"948737652119031808",9,129,80,18,236
"948738634722742273",22,165,97,26,310
"948739073237311488",22,257,306,59,644
"948872192284155904",24,267,247,47,585
"948874586006925313",30,370,199,58,657
"948879774277128197",11,147,183,24,365
"948881133340708864",25,262,236,28,551
"948944124132167680",20,203,148,41,412
"949066181381632001",25,254,169,56,504
"949070800417640454",20,191,155,29,395
"949126530839572481",35,176,477,61,749
"949129410208202757",20,206,362,48,636
"949242950659313669",30,253,209,39,531
"949287555660500992",19,243,526,56,844
"949303089416294401",24,116,262,32,434
"949495534003412992",19,218,46,31,314
"949498795074736129",27,156,513,69,765
"949608746497576960",29,290,131,34,484
"949610896241946626",22,175,121,32,350
"949616329463615489",32,291,338,68,729
"949618475877765120",83,194,700,72,1049
"949619270631256064",64,191,999,139,1393
"950012437788585985",18,132,90,23,263
"950014185299210240",31,240,494,105,870
"950023175907266560",32,207,663,73,975
"950103659337134080",52,256,535,97,940
"950105312782114817",19,146,171,26,362
"950206338411499520",13,147,134,13,307
"950206523690639360",18,156,181,25,380
"950371619247153154",40,262,245,46,593
"950443653666713601",9,94,62,15,180
"950501926227136512",11,96,33,5,145
"950502279785959425",17,143,55,12,227
"950507353094356993",19,154,248,33,454
"950777029816963072",34,232,75,27,368
"950823813868122112",16,133,42,19,210
"950862709599465472",16,107,39,25,187
"950866561153331202",24,187,35,13,259
"950884128379035650",21,210,276,128,635
"950937350003183618",12,92,53,5,162
"950946293077209088",6,117,25,8,156
"951094078661414912",25,233,227,77,562
"951106475254059008",20,176,371,53,620
"951109942685126656",25,216,606,67,914
"951184020150382592",13,94,78,12,197
"951204878562549767",10,74,35,9,128
"951229113897013248",18,127,123,36,304
"951236634095308800",25,189,75,17,306
"951309956720087041",41,296,110,35,482
"951416674808467461",24,212,242,42,520
"951419415794511872",24,184,219,41,468
"951431836030459905",25,135,193,35,388
"951441504203104256",14,138,150,23,325
"951457382651056128",15,109,148,12,284
"951478281303416832",14,126,136,15,291
"951596346011680768",11,111,119,16,257
"951645893513613312",9,117,194,30,350
"951646736233189377",8,114,65,8,195
"951647402599026689",14,162,52,15,243
"951648197440569344",17,186,89,16,308
"951650274032209920",15,193,284,55,547
"951675713089888256",30,235,249,61,575
"951679619341737986",35,183,933,97,1248
"951785587765280768",21,185,101,46,353
"951788342647107584",19,214,130,33,396
"951790999784783872",18,186,152,36,392
"951793123985973248",28,200,383,73,684
"951798415301718017",28,252,224,69,573
"951813216291708928",52,274,777,133,1236
"951875499537641472",25,205,320,48,598
"952166643202916352",17,207,132,31,387
"952166857670320128",17,161,159,47,384
"952166927476183040",26,284,272,48,630
"952183458922672130",24,232,297,100,653
"952301373479104512",26,256,645,98,1025
"952525384242876416",12,173,162,28,375
"952526145064505345",14,131,96,19,260
"952528011869478912",26,245,351,61,683
"952530515894169601",28,303,331,53,715
"952538350333939713",14,212,203,32,461
"952540700683497472",9,180,214,28,431
"952887520790040576",14,183,163,51,411
"952888691944550401",14,192,190,29,425
"953000902331453442",18,268,516,100,902
"953264081871495168",10,170,186,28,394
"953267506004754432",11,207,133,39,390
"953270558573154305",12,201,235,40,488
"953271789790138368",6,112,167,34,319
"953352036309000194",10,151,138,26,325
"953360619834691585",4,61,64,10,139
"953768657221451776",9,129,19,13,170
"953771038114045954",19,200,39,11,269
"953772162665590787",24,174,65,15,278
"953773110553186312",13,103,56,17,189
"953794085751574534",36,307,381,67,791
"953948941674078208",21,176,157,40,394
"953951365532876800",33,219,182,50,484
"953979393180950528",27,220,244,58,549
"953984671674662912",20,93,110,16,239
"953987636057821184",20,168,302,47,537
"954092417250222082",12,124,53,26,215
"954097213608570880",18,222,103,34,377
"954136290768846850",17,171,137,54,379
"954323750949982208",27,200,400,73,700
"954386490842378241",10,72,33,8,123
"954390114968498176",15,115,98,57,285
"954423170299199488",16,228,106,17,367
"954478044487520257",11,101,91,46,249
"954541219970977793",28,274,460,131,893
"954678287820902401",37,205,488,113,843
"954681839419101185",32,253,242,41,568
"954722155463430145",43,355,528,159,1085
"954901073587834882",7,35,99,15,156
"955056249925750784",38,435,469,158,1100
"955426609326100480",28,265,198,52,543
"955428815777533952",17,161,305,48,531
"955458357200130049",13,178,244,60,495
"955764970590961665",21,211,232,40,504
"955771016319590400",38,319,166,79,602
"956012274942128128",27,257,314,70,668
"956015565776277510",29,313,354,114,810
"956134228726558720",30,294,216,60,600
"956261892640604161",34,173,207,20,434
"956298399946563585",15,125,130,18,288
"956578887160532992",8,128,51,18,205
"956588348864454656",12,126,41,18,197
"956657520562573312",15,151,45,10,221
"956831942351183873",4,44,17,7,72
"956840839627595776",9,78,45,22,154
"956849981528379392",8,83,20,8,119
"956873004776116225",7,81,46,34,168
"956937916374138880",16,182,110,45,353
"956938973326098432",29,227,199,75,530
"957032249509097472",12,134,86,20,252
"957334999522533376",26,207,129,20,382
"957387711693905925",18,146,64,11,239
"957462746060206080",41,414,169,102,726
"957465263129219073",26,307,263,69,665
"957603800579297280",64,442,616,127,1249
"958070403901124609",14,116,116,26,272
"958520216429957121",17,188,214,174,593
"959268334935203840",22,225,185,45,477
"959389424806191104",37,329,584,81,1031
"959393270144086016",42,424,337,91,894
"959488037766955009",18,226,174,34,452
"959488369293254658",10,115,205,29,359
"959798743842349056",30,316,1044,127,1517
"959946200488271872",25,244,287,51,607
"959949725028974592",28,317,252,53,650
"959952974826098688",27,294,257,53,631
"960195808141414400",18,174,71,16,279
"960361010904338432",86,344,162,43,635
"960487657691385856",20,191,187,26,424
"960492998734868480",42,362,672,122,1198
"960869939694505984",23,160,63,16,262
"960907362109452288",23,201,191,26,441
"961008057756127232",13,126,72,19,230
"961038807658352640",24,260,153,51,488
"961073467784421382",30,221,121,18,390
"961270833569202176",32,258,271,88,649
"961298788219420672",9,87,39,9,144
"961362249880252416",8,92,24,4,128
"961649129834283008",23,258,188,29,498
"961671974153080834",16,115,116,40,287
"961693860916289536",28,275,224,33,560
"961743032952459264",16,196,125,23,360
"961802557646569475",34,323,343,55,755
"961957671246159875",36,217,126,28,407
"961959738853548033",30,233,195,42,500
"961962694650757121",16,177,207,31,431
"962326008127946752",7,108,80,34,229
"962345433170415616",21,265,218,54,558
"962389786328797184",23,222,188,46,479
"962394439846191105",15,158,133,16,322
"962398269593784321",20,252,380,56,708
"962435602296786944",18,155,49,13,235
"962469767109009408",25,260,218,62,565
"962753552824365056",31,260,283,42,616
"962787355932360706",16,117,59,9,201
"963031666150313984",35,236,171,57,499
"963033580107653120",16,135,96,19,266
"963839056533626880",6,111,84,13,214
"963853233000275969",7,95,71,10,183
"963878055969198080",55,351,848,116,1370
"963879275324760070",27,156,340,52,575
"964190995687591936",16,169,257,42,484
"964232645495459840",12,115,270,37,434
"964509154357411840",15,157,368,75,615
"964512164865363968",15,178,488,62,743
"964594780088033282",29,315,887,114,1345
"964724390637244417",18,210,371,50,649
"964938678362628096",11,122,175,20,328
"964944088696049666",11,140,145,18,314
"964949269374529538",27,187,346,43,603
"964955496137535488",15,132,111,13,271
"964956781670694912",11,115,193,23,342
"965075589274177536",35,272,966,123,1396
"965079126829871104",27,233,489,51,800
"965194903142719489",28,316,295,58,697
"965199840471810049",21,235,319,34,609
"965202556204003328",28,259,424,59,770
"965205208191168512",18,167,332,63,580
"965212168449941505",32,277,558,67,934
"965221024496279552",23,135,157,34,349
"965223354633457665",11,189,213,37,450
"965272331978407937",16,159,189,16,380
"965303158229622785",11,137,167,17,332
"965442990134251520",33,245,857,145,1280
"965582280772276224",26,176,531,108,841
"965676314576543744",20,183,607,88,898
"965780052167286784",10,97,327,38,472
"965925223949357056",10,116,168,11,305
"965928352614965248",13,127,93,24,257
"965930611272712192",13,170,185,28,396
"965932714141650946",11,146,137,11,305
"965935035328155649",6,81,69,11,167
"965937068907073536",19,184,258,41,502
"965943827931549696",15,112,676,72,875
"965968309358333952",18,169,434,75,696
"965971586913374208",16,167,208,33,424
"966117265426001920",21,177,197,41,436
"966118856874971138",16,187,149,36,388
"966119932793585664",30,142,213,48,433
"966317112565420033",26,203,125,36,390
"966321700588711936",26,251,437,59,773
"966377081469882368",13,127,51,10,201
"966420452070559749",14,169,41,15,239
"966487844662456320",27,224,218,44,513
"966650397002813440",21,175,257,59,512
"966653833047887874",22,183,264,56,525
"966660169194229761",21,189,436,74,720
"966662241977360384",91,288,263,137,779
"966687491616059392",26,183,146,57,412
"966711641378381826",26,181,25,12,244
"966766375292358659",15,148,145,53,361
"966846679784837120",24,240,329,59,652
"967023015035797504",16,95,399,51,561
"967023714268319744",17,181,183,29,410
"967083810981597185",17,159,102,26,304
"967084806726127616",15,172,106,24,317
"967146956094083073",8,66,47,5,126
"967168890232082433",13,125,59,8,205
"967388904952344577",12,173,62,19,266
"967472757025001472",15,159,434,83,691
"967493467046899712",15,181,201,36,433
"967508938425069568",20,164,156,42,382
"967526110249537542",21,211,292,79,603
"967538684789739520",19,146,302,34,501
"967539664692350977",15,172,130,16,333
"967545724362739712",13,137,295,45,490
"967563946063523840",11,143,259,45,458
"968455547094753281",16,173,117,24,330
"968462966864609280",10,121,138,17,286
"968467243192537088",18,201,207,26,452
"968468176639004672",38,127,660,67,892
"968550893015707649",10,98,79,13,200
"968702480753315840",13,127,123,28,291
"968704442110545923",21,182,130,26,359
"968818810005450752",20,190,130,35,375
"968825596133478400",19,178,197,53,447
"968856971075051521",27,194,346,115,682
"968896168230051850",21,128,72,14,235
"968917941671612416",11,111,44,21,187
"968924154031497226",19,147,50,13,229
"968962582374621185",15,84,165,33,297
"969183644756660224",20,182,104,33,339
"969272683061022721",8,122,64,11,205
"969277822920470530",7,78,39,10,134
"969311530733981698",4,78,52,16,150
"969324283036971009",7,87,69,19,182
"969374597127778304",11,112,91,17,231
"969374909209239552",10,104,62,12,188
"969525362580484098",28,169,250,51,498
"969529668234829825",40,186,482,91,799
"969660692419657728",18,174,78,26,296
"969939200933056512",17,170,209,28,424
"969989251537481730",15,145,226,34,420
"969991653393039361",22,232,187,47,488
"969994273121820672",27,203,209,64,503
"970650759091163137",30,335,478,86,929
"970760324126212096",23,260,246,77,606
"971006379375972354",27,191,278,57,553
"971007733313961984",12,112,100,34,258
"971008891751485440",7,69,25,5,106
"971013841395027968",58,265,418,78,819
"971019306388611073",20,179,129,30,358
"971335759679709185",4,53,99,11,167
"971349864125788160",30,277,179,56,542
"971402791930552322",17,141,71,20,249
"971409845453762560",18,146,156,21,341
"971812821955735552",15,94,164,14,287
"971915531346436096",46,281,148,77,552
"972151933782974464",19,138,101,28,286
"972210637018423301",14,102,42,8,166
"972242845636669440",15,144,43,15,217
"972271520847466498",22,210,107,48,387
"972466816114032640",17,118,62,13,210
"972500344197566465",15,158,26,19,218
"972506194978983937",17,136,58,21,232
"972523294233710593",12,117,30,9,168
"972538115901607937",15,109,61,21,206
"972542173030879233",16,121,71,19,227
"972563247160274947",17,157,122,42,338
"972585290857672704",15,159,74,22,270
"972622325454659585",4,59,42,8,113
"972647673944780802",14,156,118,25,313
"972829763067883523",28,165,194,26,413
"972832210222043137",26,147,235,35,443
"972835128056664066",11,146,182,30,369
"972846978823610369",20,206,171,22,419
"972853747750711296",21,194,398,59,672
"973171763835228162",18,129,47,6,200
"973185831547670529",17,146,113,29,305
"973187513731944448",17,84,160,35,296
"973199981292216320",16,140,147,20,323
"973207890084401152",11,108,90,8,217
"973305935685963776",14,116,32,8,170
"973360355790479361",37,368,809,134,1348
"973536164044034048",15,159,117,24,315
"973540316656623616",91,301,346,57,795
"973568677189595136",21,127,121,49,318
"973580538358374402",11,148,191,31,381
"973581274215473153",28,279,299,77,683
"973685997312491521",20,204,231,44,499
"973716838889660416",12,131,79,10,232
"973719038982479872",15,157,88,8,268
"973907142649397251",24,212,316,52,604
"973909651065528320",14,103,109,16,242
"973920392543793154",12,94,77,9,192
"973931154796457984",17,130,177,16,340
"974032596563832832",6,55,26,6,93
"974033924493111296",21,176,136,36,369
"974069957905428481",10,103,58,11,182
"974141083054690304",15,136,20,10,181
"974241711315709954",13,142,101,28,284
"974276383051583488",19,111,307,32,469
"974341417509249024",5,75,61,16,157
"974462702264479744",7,102,48,6,163
"974656757187440640",18,186,31,11,246
"974683485322596352",12,140,147,26,325
"974702363763232768",11,117,95,16,239
"974859881827258369",45,379,1019,159,1602
"975024181061541888",15,118,90,33,256
"975057131136274432",24,263,373,54,714
"975062797162811394",29,306,484,91,910
"975163071361683456",26,234,696,102,1058
"975341676297445377",22,204,273,41,540
"975346628113596417",33,228,540,86,887
"975350027169206273",30,274,832,118,1254
"975707627182219266",8,53,186,27,274
"975720503997620224",24,153,644,69,890
"975891861863829504",19,158,292,53,522
"976120272435793920",37,307,232,31,607
"976405122757558272",31,221,122,19,393
"976411208717950976",14,131,68,14,227
"976415945714556928",25,177,220,32,454
"976420417090015232",20,142,340,62,564
"976532956557737984",30,175,359,66,630
"976535330835836929",27,143,261,45,476
"976654851684945920",22,190,282,182,676
"976655903729610752",11,145,166,61,383
"976765417908776963",101,404,865,180,1550
"976770619424563200",21,155,423,74,673
"976891486510907393",13,118,120,33,284
"976914287217258497",8,97,43,13,161
"976948306927607810",35,215,331,73,654
"977124622285066240",21,174,189,46,430
"977159683151712258",12,143,183,73,411
"977166887493799936",50,330,386,488,1254
"977221676697079808",15,74,107,164,360
"977286489410240514",33,137,237,66,473
"977585879651966980",14,125,196,28,363
"977850135697911808",12,125,66,13,216
"977855968364171264",20,245,291,71,627
"977858212635594752",14,166,212,55,447
"977872899792089088",15,110,333,36,494
"977875057572745216",22,138,341,47,548
"977894983083708416",10,121,57,14,202
"977904367524372481",14,85,102,17,218
"978110975428657153",16,165,223,36,440
"978226474485534720",15,157,182,39,393
"978249938743234560",19,211,382,63,675
"978368319542702080",14,123,174,31,342
"978432632273948674",17,176,113,32,338
"978701966456082433",19,127,83,23,252
"978932860307505153",51,471,337,98,957
"978936058795757568",23,201,89,21,334
"978938860582440960",27,180,80,19,306
"979028987858112512",9,93,19,4,125
"979030033149972480",26,243,68,42,379
"979030109104562176",16,131,71,14,232
"979082457340407808",29,216,236,44,525
"979108653377703936",28,142,118,20,308
"979108846408003584",13,84,63,6,166
"979326715272065024",40,242,446,97,825
"979444104923840513",14,141,65,9,229
"979447750529110017",13,141,94,13,261
"979449770640015361",20,195,164,23,402
"979816766904954880",23,178,85,45,331
"980063581592047617",16,145,216,61,438
"980065419632566272",16,153,289,42,500
"980065427375128576",29,270,315,87,701
"980421275326865409",33,246,172,115,566
"980443810529533952",30,264,381,87,762
"980451155548491777",24,232,262,51,569
"980451798606602241",17,149,313,58,537
"980762392303980544",17,146,87,31,281
"980764358530789380",20,183,127,31,361
"980766121983987712",19,178,219,27,443
"980794173279342592",15,140,80,24,259
"980799183425802240",18,130,300,45,493
"980800783313702918",14,129,242,48,433
"980806557846863872",15,142,261,47,465
"980832496005844993",9,71,86,11,177
"980846943130746881",8,97,46,10,161
"980958298445885446",18,169,177,37,401
"980961086546632705",14,143,109,21,287
"980964100502118400",21,254,240,70,585
"980966813843509249",12,144,166,60,382
"980989085631225857",26,134,24,17,201
"981117684489379840",11,132,202,39,384
"981121409807155200",19,208,125,42,394
"981123772169191424",12,119,182,25,338
"981126375716409344",18,172,524,75,789
"981168344924536832",19,135,509,94,757
"981248899166932994",5,69,40,7,121
"981259962717388801",16,149,124,46,335
"981287536520847360",23,137,204,21,385
"981491439233355776",20,176,132,35,363
"981492087328792577",22,271,199,50,542
"981521901079146499",11,108,167,35,321
"981544432762802176",20,133,19,4,176
"981548354088898560",20,136,170,22,348
"981859214380462081",12,149,175,31,367
"981881669593559040",20,178,231,42,471
"981987882712883200",12,122,106,36,276
"981992052786425856",5,86,45,6,142
"982353975595929600",6,62,46,5,119
"982673223719489536",11,101,22,4,138
"982680387116781568",15,180,76,17,288
"982682227581636608",16,186,126,36,364
"982722926305832960",13,187,87,30,317
"982724858743328777",18,221,226,57,522
"982770847046922240",17,159,316,41,533
"982943088330108928",13,134,143,20,310
"982950739441004544",19,130,179,20,348
"982954355509907457",18,160,110,20,308
"982966315467116544",47,186,123,35,391
"982967389028569088",12,105,52,7,176
"982969547283161090",19,146,331,35,531
"983143317889323008",11,83,67,21,182
"983284198046826496",46,384,123,64,617
"983423715332558848",18,213,225,65,521
"983427438691708929",7,72,163,15,257
"983662868540346371",33,199,545,103,880
"983662953894436864",41,194,603,110,948
"983698762760704000",18,156,89,19,282
"983774270886236161",11,186,49,19,265
"983824424532144128",5,123,33,9,170
"984015782521835521",11,138,77,14,240
"984017894240604161",14,133,91,29,267
"984020136255541248",16,146,182,44,388
"984022625440747520",54,255,302,94,705
"984032798821568513",24,175,166,40,405
"984053549742067712",24,208,396,57,685
"984066131303583746",12,67,176,41,296
"984095671262367744",5,61,25,5,96
"984155907251687424",12,130,69,17,228
"984231791103012864",17,89,181,31,318
"984371491277099010",14,130,112,20,276
"984372760230154241",12,109,39,18,178
"984374422587965440",26,146,281,83,536
"984379918682394624",8,88,55,9,160
"984471933050937344",17,156,46,6,225
"984472778035417088",13,149,189,34,385
"984479558765350912",0,0,45,7,52
"984499517805486082",9,107,45,7,168
"984507430909308929",13,163,150,31,357
"984631073865953280",13,149,79,17,258
"984759315046322177",14,200,184,22,420
"984763579210633216",32,266,464,66,828
"984767560494313472",36,264,698,102,1100
"984828878060335109",22,191,182,18,413
"984877999718895616",33,291,641,92,1057
"984967457315139586",30,191,120,45,386
"985130802668294144",38,291,271,65,665
"985133017256660995",22,232,168,30,452
"985483513704124416",19,210,204,33,466
"985487209510948864",20,214,191,37,462
"985489930343321600",23,227,140,23,413
"985492862958698497",26,189,234,24,473
"985496023555608576",21,181,320,42,564
"985502053345751040",27,194,440,74,735
"985504808646971392",17,163,463,60,703
"985529299905187840",18,223,423,70,734
"985856662866202624",17,224,300,51,592
"985858100149309441",17,132,120,17,286
"986218862625648640",18,163,99,34,314
"986218867780448261",8,89,75,7,179
"986218870506754048",18,126,105,27,276
"986218871991492608",10,119,211,25,365
"986301228337508354",5,74,43,10,132
"986303188587425794",15,135,165,26,341
"986344953134673922",4,71,25,4,104
"986357228306354178",17,105,35,16,173
"986357230219022342",10,76,42,7,135
"986430103075868672",7,66,39,4,116
"986430856750395392",4,40,11,4,59
"986432143189512192",24,145,189,32,390
"986436520444866560",15,115,69,19,218
"986544648477868032",21,235,289,38,583
"986547093610299392",13,123,201,29,366
"986555533535731712",17,178,57,24,276
"986576502358671361",26,156,455,63,700
"986643179452747776",16,214,47,6,283
"986711015630036992",11,94,91,17,213
"986719240240746497",9,85,45,8,147
"986801143014621185",8,90,51,10,159
"986979039670931458",8,112,37,7,164
"986988633822412800",15,179,54,16,264
"986994992177561600",13,180,120,38,351
"987003860882526208",4,64,35,11,114
"987036458648199168",2,49,12,0,63
"987038167730552832",10,137,68,9,224
"987063604691259393",17,219,211,45,492
"987065049566138375",10,174,70,20,274
"987066289855303681",14,193,72,14,293
"987173366401585155",25,197,304,54,580
"987278269765517312",23,256,358,52,689
"987280537348866048",20,166,161,33,380
"987282387196436480",23,248,130,38,439
"987284041304100864",19,166,88,32,305
"987426984195174405",20,256,238,53,567
"987463564305797126",36,307,66,33,442
"987470932989050881",20,261,168,57,506
"987529636656697345",27,234,403,69,733
"987532088302886913",23,190,75,21,309
"987679848284999680",21,104,187,23,335
"987679850545778689",9,77,86,7,179
"987679852345135105",12,85,159,25,281
"987682105269391360",4,79,76,8,167
"987718832096768001",7,118,83,17,225
"987718953886679047",10,113,91,15,229
"987719560282476546",10,102,296,31,439
"987766033862873091",12,176,107,38,333
"987768453338673152",28,153,116,32,329
"987774054651301888",15,149,185,26,375
"987786331995672576",14,135,224,36,409
"987820963038449664",11,164,151,29,355
"988030312088260608",15,168,111,35,329
"988037292932653056",24,199,244,38,505
"988040227167064064",16,161,106,24,307
"988056354567917568",9,119,148,17,293
"988106076028653568",17,122,298,47,484
"988126197619068928",15,224,107,35,381
"988146462625181696",22,208,178,36,444
"988148545545895937",11,147,75,19,252
"988405962624118785",16,178,261,35,490
"988413372298416128",14,208,146,47,415
"988415011382091776",24,191,132,33,380
"988509958089166848",27,251,176,29,483
"988820755164139521",10,76,36,9,131
"988839027209097217",6,50,22,2,80
"988840512571441152",9,136,43,9,197
"988850347031584768",7,86,29,5,127
"988856839893897222",9,112,65,4,190
"988859727219187713",4,66,44,7,121
"988874883990999040",19,148,88,21,276
"989110172495810560",14,237,104,25,380
"989134248010502146",12,94,73,16,195
"989144622684409856",18,154,87,36,295
"989144989690187776",19,130,74,36,259
"989225812166696960",127,625,140,31,923
"989252420294336512",59,338,138,27,562
"989629633376194561",13,88,243,31,375
"989650212380692480",22,160,154,33,369
"989813047773614080",23,183,208,44,458
"989816772713906177",22,156,43,20,241
"989820401596366849",36,247,58,29,370
"989827358961086465",12,110,21,6,149
"989834048796266498",25,171,25,14,235
"989854486310113282",41,239,141,27,448
"989858791687671808",9,101,46,15,171
"989870523042680832",32,273,313,67,685
"989948140814991360",15,96,45,7,163
"990049088375836672",22,205,189,56,472
"990200773232529413",20,243,125,36,424
"990202926114189312",20,209,119,18,366
"990213619190202369",15,179,145,33,372
"990225456233316354",22,147,33,13,215
"990227703575056384",9,137,106,22,274
"990307626784362496",28,350,179,56,613
"990551654952067073",13,175,96,21,305
"990557728752926725",23,168,166,41,398
"990559834020962304",21,196,335,59,611
"990764965282893827",13,110,50,10,183
"990782291667488768",21,174,310,46,551
"990787671281819648",20,129,77,21,247
"990926480329859073",19,174,251,42,486
"990928644100034561",16,129,103,57,305
"991028027785138177",25,255,94,42,416
"991267863674675200",22,212,422,60,716
"991271009570484224",18,157,45,15,235
"991279620044591105",17,198,360,47,622
"991337381654654976",8,65,37,3,113
"991360908868931585",10,93,24,6,133
"991380274452803586",7,80,12,1,100
"991402619552845825",15,133,42,10,200
"991644756995444736",26,204,278,73,581
"991669454823141376",16,136,169,29,350
"991672075491438594",14,202,253,32,501
"991690248399794176",26,239,370,110,745
"991743358312861696",8,109,37,4,158
"991776286489169920",16,159,41,11,227
"991843153953964033",15,179,214,37,445
"991884309400342529",12,149,83,14,258
"991886413686861824",9,125,63,19,216
"991992302267785216",19,145,206,40,410
"991994433750142976",20,134,188,37,379
"991995845120753664",20,136,468,65,689
"992078098974703616",8,104,88,12,212
"992083738531192833",15,159,54,6,234
"992106689330663424",6,97,101,19,223
"992348740529815552",13,162,126,21,322
"992350362450518016",13,169,64,17,263
"992352585863651329",3,48,41,1,93
"992354530510721025",17,158,175,28,378
"992357529362583552",6,73,92,15,186
"992395376039727104",27,228,196,59,510
"992503576852393985",11,160,101,19,291
"992523949698412544",38,278,272,42,630
"992524132884664321",24,197,79,20,320
"992556495182155776",10,77,64,9,160
"992558888212946949",13,131,111,22,277
"992562394051293186",18,131,79,13,241
"992880573025865729",10,117,78,9,214
"993443781281271808",18,125,70,14,227
"993446539988217857",15,201,123,23,362
"993452275648679938",16,169,227,26,438
"993455375755173892",27,247,226,28,528
"993475610377932801",12,94,52,12,170
"993476979893723137",13,101,22,5,141
"993483042177118208",17,168,157,20,362
"993484478633922560",16,174,191,40,421
"993492804985872385",30,249,139,42,460
"993541175511527425",12,99,54,4,169
"993562242124865536",29,175,143,44,391
"993810085540491264",21,173,64,19,277
"993813485745295360",20,134,63,12,229
"993815373190492160",28,258,211,60,557
"993926510003277825",21,167,109,25,322
"993976643898281984",18,165,198,31,412
"994176238846664706",14,152,82,18,266
"994179864436596736",22,186,509,96,813
"994182263960162304",23,276,68,15,382
"994185337504137216",10,114,48,4,176
"994192995737096192",51,361,46,63,521
"994194233111273472",25,230,83,44,382
"994401394441453569",11,173,75,28,287
"994517833357946882",44,446,68,65,623
"994585463380987904",14,229,209,45,497
"994586105822564353",69,464,56,41,630
"994587349718847489",73,338,114,38,563
"994741305908649985",13,147,77,24,261
"995023303906652160",20,168,73,21,282
"995044981768425477",18,165,123,20,326
"995085901079433219",28,240,76,25,369
"995088584221839360",22,190,189,34,435
"995410516129538048",30,237,98,26,391
"995424104286179328",23,201,92,27,343
"995428472674758656",25,270,176,35,506
"995642096676671495",21,199,136,30,386
"995680316458262533",20,129,248,38,435
"995746011321597953",13,166,81,22,282
"995758467645353985",16,198,127,22,363
"995816799341088770",29,208,107,21,365
"995980604016611329",11,136,98,6,251
"996021417622851584",30,229,149,48,456
"996046634864791557",15,123,57,7,202
"996119678551552000",14,100,108,13,235
"996129630913482755",24,215,449,79,767
"996135379802755072",19,195,99,78,391
"996366330436648960",19,180,56,60,315
"996368474556583937",10,108,66,14,198
"996391840860471296",35,236,250,61,582
"996442654568341505",4,93,24,7,128
"996460197005717504",13,161,33,11,218
"996464466702274561",7,89,12,5,113
"996487798759854082",9,95,77,6,187
"996723907867676673",14,140,54,6,214
"996728397362540545",10,104,29,2,145
"996739372723638272",10,106,79,16,211
"996739374619426816",6,68,18,2,94
"996739376028835840",6,67,64,4,141
"996802784090640385",13,143,26,8,190
"996810253126787073",4,62,27,1,94
"996822738101825538",10,119,41,11,181
"996822740320575488",6,80,41,12,139
"997076300476055552",21,226,401,64,712
"997095653875617792",26,234,363,53,676
"997112687799697408",27,248,362,51,688
"997136144465842177",13,158,30,14,215
"997220260259487744",17,149,39,25,230
"997227223638790144",8,58,25,3,94
"997233764689498112",11,93,37,8,149
"997238932311068674",14,107,58,10,189
"997239623268085761",12,113,37,9,171
"997422764909912065",13,165,158,31,367
"997429518867591170",35,316,200,48,599
"997471413266247681",14,172,177,34,397
"997474432443707393",21,207,224,44,496
"997493407097524224",18,98,396,50,562
"997515759281680385",17,122,315,41,495
"997573139663028224",11,93,57,12,173
"997577906007298048",11,89,40,6,146
"997597940444221440",20,224,218,89,551
"997899870903169024",18,147,46,8,219
"997909163379449857",17,213,119,42,391
"997951982467014656",27,298,318,80,723
"998187672979038208",17,170,183,15,385
"998189366844559360",24,211,250,40,525
"998191501451628544",27,230,210,33,500
"998194013193822208",19,186,137,25,367
"998196033153839104",25,255,146,36,462
"998202784683053056",22,251,196,33,502
"998250447394820096",10,150,201,29,390
"998256454590193665",53,439,877,184,1553
"998524172858019840",15,131,65,14,225
"998525737593376768",14,131,27,7,179
"998526637657546753",8,87,27,3,125
"998528928259170305",8,102,44,4,158
"998532136578748425",25,258,186,49,518
"998534123399663616",15,164,95,10,284
"998537117180588033",19,181,138,19,357
"998546786628395009",15,198,200,38,451
"998553122179084290",16,149,145,33,343
"998704493335334912",7,132,93,17,249
"998992271629570048",9,95,32,16,152
"999010902472122368",10,89,38,9,146
"999087688983764992",18,183,274,38,513
"999096011174924289",16,181,141,24,362
"999096013674680321",19,181,228,29,457
"999242039723163648",28,275,303,44,650
"999243732506562560",12,113,59,11,195
"999246677549768704",19,176,288,48,531
"999249186762772481",14,137,389,37,577
"999252093998370817",15,188,154,19,376
"999257533327073281",10,91,88,8,197
"999258232110579714",9,107,71,5,192
"999278498182258688",17,139,79,15,250
"999282325316866048",24,138,451,58,671
"999323841351618561",5,52,31,6,94
"999371735928582144",10,104,37,13,164
"999373224059265026",12,132,100,24,268
"999435250571726848",10,79,20,6,115
"999442055670607872",9,100,115,19,243
"999454450854039552",11,113,198,35,357
"999626347361206274",20,231,416,61,728
"999629710370983937",22,266,320,43,651
"999686062082535424",11,96,116,24,247
"999687630060118016",7,96,24,11,138
"999695988813189120",14,104,134,31,283
"999710267096354819",5,65,33,5,108
"999761589476655105",7,138,25,16,186
"999984492197613568",23,145,159,28,355
"999984495179726848",28,189,304,52,573
"999984503123857408",20,154,175,30,379
"999984507574018049",27,215,212,43,497
"999986971660423170",20,169,127,30,346
